id,task,time,duration,key,gap1,gap2
A,1,226,96,F,359,263
A,1,585,121,a,244,123
A,1,829,64,r,140,76
A,1,969,73, ,322,249
A,1,1291,76,o,211,135
A,1,1502,64,u,226,162
A,1,1728,64,t,213,149
A,1,1941,80, ,470,390
A,1,2411,61,i,153,92
A,1,2564,33,n,115,82
A,1,2679,56, ,171,115
A,1,2850,56,t,148,92
A,1,2998,64,h,143,79
A,1,3141,69,e,73,4
A,1,3214,48, ,350,302
A,1,3564,72,u,160,88
A,1,3724,64,n,179,115
A,1,3903,76,c,108,32
A,1,4011,52,h,120,68
A,1,4131,100,a,209,109
A,1,4340,76,r,456,380
A,1,4796,28,y,944,916
A,1,5740,61,t,186,125
A,1,5926,80,e,148,68
A,1,6074,96,d,80,-16
A,1,6154,64, ,291,227
A,1,6445,61,b,123,62
A,1,6568,65,a,188,123
A,1,6756,56,c,92,36
A,1,6848,76,k,309,233
A,1,7157,85,w,189,104
A,1,7346,92,a,76,-16
A,1,7422,72,t,190,118
A,1,7612,88,e,150,62
A,1,7762,88,r,208,120
A,1,7970,84,s,128,44
A,1,8098,76, ,177,101
A,1,8275,96,o,161,65
A,1,8436,80,f,84,4
A,1,8520,72, ,182,110
A,1,8702,60,t,167,107
A,1,8869,64,h,124,60
A,1,8993,73,e,84,11
A,1,9077,48, ,592,544
A,1,9669,48,n,1875,1827
A,1,11544,52,u,668,616
A,1,12212,49,n,906,857
A,1,13118,84,f,196,112
A,1,13314,116,a,138,22
A,1,13452,84,s,115,31
A,1,13567,73,h,142,69
A,1,13709,84,i,437,353
A,1,14146,84,o,267,183
A,1,14413,32,n,247,215
A,1,14660,88,a,127,39
A,1,14787,52,b,194,142
A,1,14981,72,l,122,50
A,1,15103,76,e,156,80
A,1,15259,40, ,561,521
A,1,15820,84,e,113,29
A,1,15933,68,n,96,28
A,1,16029,83,d,124,41
A,1,16153,76, ,195,119
A,1,16348,72,o,131,59
A,1,16479,76,f,64,-12
A,1,16543,76, ,191,115
A,1,16734,69,t,155,86
A,1,16889,60,h,115,55
A,1,17004,64,e,80,16
A,1,17084,64, ,377,313
A,1,17461,89,w,158,69
A,1,17619,80,e,222,142
A,1,17841,88,s,141,53
A,1,17982,80,t,385,305
A,1,18367,120,e,154,34
A,1,18521,89,r,133,44
A,1,18654,40,n,135,95
A,1,18789,80, ,756,676
A,1,19545,80,s,492,412
A,1,20037,40,p,214,174
A,1,20251,48,i,157,109
A,1,20408,68,r,226,158
A,1,20634,72,a,120,48
A,1,20754,76,l,233,157
A,1,20987,52, ,124,72
A,1,21111,92,a,218,126
A,1,21329,76,r,164,88
A,1,21493,44,m,165,121
A,1,21658,76, ,180,104
A,1,21838,88,o,150,62
A,1,21988,84,f,72,-12
A,1,22060,60, ,196,136
A,1,22256,83,t,171,88
A,1,22427,68,h,110,42
A,1,22537,64,e,76,12
A,1,22613,96, ,572,476
A,1,23185,52,G,646,594
A,1,23831,104,a,327,223
A,1,24158,100,l,325,225
A,1,24483,64,a,216,152
A,1,24699,80,x,139,59
A,1,24838,72,y,811,739
A,1,25649,36, ,265,229
A,1,25914,80,l,217,137
A,1,26131,64,i,135,71
A,1,26266,84,e,173,89
A,1,26439,97,s,127,30
A,1,26566,64, ,149,85
A,1,26715,112,a,141,29
A,1,26856,40, ,448,408
A,1,27304,100,s,293,193
A,1,27597,40,m,118,78
A,1,27715,92,a,256,164
A,1,27971,36,l,753,717
A,1,28724,48,l,491,443
A,1,29215,32, ,399,367
A,1,29614,52,u,173,121
A,1,29787,76,n,311,235
A,1,30098,76,r,189,113
A,1,30287,68,e,181,113
A,1,30468,55,g,1620,1565
A,1,32088,116,a,347,231
A,1,32435,111,r,359,248
A,1,32794,100,e,212,112
A,1,33006,101,d,1179,1078
A,1,34185,84,d,299,215
A,1,34484,61,e,146,85
A,1,34630,128,d,112,-16
A,1,34742,72, ,1161,1089
A,1,35903,60,y,133,73
A,1,36036,72,e,138,66
A,1,36174,60,l,150,90
A,1,36324,40,l,152,112
A,1,36476,56,o,408,352
A,1,36884,80,w,162,82
A,1,37046,53, ,230,177
A,1,37276,96,s,88,-8
A,1,37364,68,u,156,88
A,1,37520,44,n,688,644
A,1,38208,52,.,1908,1856
A,1,40116,100,O,365,265
A,1,40481,44,r,319,275
A,1,40800,69,b,231,162
A,1,41031,60,i,613,553
A,1,41644,56,t,302,246
A,1,41946,48,i,185,137
A,1,42131,48,n,170,122
A,1,42301,52,g,129,77
A,1,42430,84, ,181,97
A,1,42611,64,t,163,99
A,1,42774,64,h,178,114
A,1,42952,60,i,126,66
A,1,43078,76,s,84,8
A,1,43162,72, ,153,81
A,1,43315,119,a,116,-3
A,1,43431,60,t,160,100
A,1,43591,68, ,121,53
A,1,43712,95,a,95,0
A,1,43807,41, ,114,73
A,1,43921,96,s,184,88
A,1,44105,61,i,749,688
A,1,44854,64,d,95,31
A,1,44949,84,i,133,49
A,1,45082,49,s,450,401
A,1,45532,56,t,149,93
A,1,45681,80,a,125,45
A,1,45806,40,n,144,104
A,1,45950,72,c,197,125
A,1,46147,59,e,113,54
A,1,46260,68, ,198,130
A,1,46458,68,o,113,45
A,1,46571,68,f,99,31
A,1,46670,56, ,172,116
A,1,46842,36,e,95,59
A,1,46937,61,o,163,102
A,1,47100,52,u,211,159
A,1,47311,48,p,221,173
A,1,47532,52,l,1582,1530
A,1,49114,52,r,106,54
A,1,49220,64,o,178,114
A,1,49398,52,u,200,148
A,1,49598,53,p,1654,1601
A,1,51252,40,u,258,218
A,1,51510,28,g,709,681
A,1,52219,56,g,147,91
A,1,52366,60,h,263,203
A,1,52629,45,l,287,242
A,1,52916,41,y,692,651
A,1,53608,49, ,285,236
A,1,53893,68,n,164,96
A,1,54057,68,i,886,818
A,1,54943,56,n,307,251
A,1,55250,76,e,148,72
A,1,55398,68,t,180,112
A,1,55578,65,y,1555,1490
A,1,57133,49,t,337,288
A,1,57470,68,w,167,99
A,1,57637,60,o,252,192
A,1,57889,40, ,436,396
A,1,58325,40,m,170,130
A,1,58495,61,i,533,472
A,1,59028,48,l,127,79
A,1,59155,52,l,169,117
A,1,59324,48,i,155,107
A,1,59479,61,o,191,130
A,1,59670,36,n,119,83
A,1,59789,57, ,216,159
A,1,60005,52,m,197,145
A,1,60202,64,i,150,86
A,1,60352,77,l,121,44
A,1,60473,64,e,477,413
A,1,60950,80,s,113,33
A,1,61063,45, ,161,116
A,1,61224,69,i,187,118
A,1,61411,41,n,660,619
A,1,62071,57,s,96,39
A,1,62167,45, ,634,589
A,1,62801,57, ,202,145
A,1,63003,89,a,128,39
A,1,63131,45,n,222,177
A,1,63353,49, ,1109,1060
A,1,64462,109,a,80,-29
A,1,64542,49,n,120,71
A,1,64662,77, ,495,418
A,1,65157,44,u,328,284
A,1,65485,52,t,152,100
A,1,65637,55,t,129,74
A,1,65766,84,e,144,60
A,1,65910,61,r,105,44
A,1,66015,37,l,617,580
A,1,66632,60,y,546,486
A,1,67178,48, ,614,566
A,1,67792,69,i,171,102
A,1,67963,53,n,121,68
A,1,68084,76,s,325,249
A,1,68409,72,i,936,864
A,1,69345,73,i,228,155
A,1,69573,65,g,303,238
A,1,69876,56,n,156,100
A,1,70032,64,i,159,95
A,1,70191,60,f,84,24
A,1,70275,57,i,180,123
A,1,70455,109,c,201,92
A,1,70656,115,a,107,-8
A,1,70763,28,t,713,685
A,1,71476,68,n,216,148
A,1,71692,64,t,450,386
A,1,72142,72, ,700,628
A,1,72842,52,l,315,263
A,1,73157,56,i,349,293
A,1,73506,39,t,151,112
A,1,73657,49,t,285,236
A,1,73942,47,l,147,100
A,1,74089,69,e,114,45
A,1,74203,44, ,197,153
A,1,74400,65,b,174,109
A,1,74574,25,u,572,547
A,1,75146,49,k,997,948
A,1,76143,57,l,223,166
A,1,76366,53,u,104,51
A,1,76470,76,e,84,8
A,1,76554,65, ,204,139
A,1,76758,52,g,126,74
A,1,76884,85,r,148,63
A,1,77032,88,e,829,741
A,1,77861,57,e,184,127
A,1,78045,41,n,137,96
A,1,78182,65, ,250,185
A,1,78432,61,p,193,132
A,1,78625,61,l,125,64
A,1,78750,96,a,141,45
A,1,78891,41,n,401,360
A,1,79292,68,e,128,60
A,1,79420,61,t,283,222
A,1,79703,45, ,162,117
A,1,79865,80,w,123,43
A,1,79988,52,h,168,116
A,1,80156,93,o,352,259
A,1,80508,88,s,155,67
A,1,80663,101,e,185,84
A,1,80848,52, ,190,138
A,1,81038,105,a,176,71
A,1,81214,97,p,195,98
A,1,81409,69,e,856,787
A,1,82265,105,d,509,404
A,1,82774,97,e,534,437
A,1,83308,104,s,279,175
A,1,83587,84,c,341,257
A,1,83928,80,e,231,151
A,1,84159,73,n,285,212
A,1,84444,101,d,226,125
A,1,84670,67,e,679,612
A,1,85349,79,d,2116,2037
A,1,87465,77, ,555,478
A,1,88020,72,l,156,84
A,1,88176,69,i,132,63
A,1,88308,69,f,234,165
A,1,88542,56,e,123,67
A,1,88665,37, ,171,134
A,1,88836,60,f,72,12
A,1,88908,61,o,143,82
A,1,89051,56,r,118,62
A,1,89169,49,m,170,121
A,1,89339,59,s,145,86
A,1,89484,40, ,132,92
A,1,89616,85,a,179,94
A,1,89795,69,r,151,82
A,1,89946,89,e,108,19
A,1,90054,73, ,165,92
A,1,90219,56,s,104,48
A,1,90323,65,o,186,121
A,1,90509,56, ,128,72
A,1,90637,89,a,134,45
A,1,90771,41,m,153,112
A,1,90924,64,a,208,144
A,1,91132,108,z,135,27
A,1,91267,77,o,1281,1204
A,1,92548,57,i,235,178
A,1,92783,93,n,238,145
A,1,93021,68,g,287,219
A,1,93308,56,l,239,183
A,1,93547,64,y,544,480
A,1,94091,63, ,281,218
A,1,94372,64,p,106,42
A,1,94478,68,r,156,88
A,1,94634,68,i,823,755
A,1,95457,35,m,193,158
A,1,95650,52,i,207,155
A,1,95857,53,t,201,148
A,1,96058,60,i,263,203
A,1,96321,64,v,875,811
A,1,97196,44,i,1591,1547
A,1,98787,64,e,183,119
A,1,98970,77, ,773,696
A,1,99743,64,t,141,77
A,1,99884,64,h,95,31
A,1,99979,104,a,80,-24
A,1,100059,61,t,137,76
A,1,100196,72, ,158,86
A,1,100354,69,t,149,80
A,1,100503,60,h,48,-12
A,1,100551,69,e,105,36
A,1,100656,60,y,190,130
A,1,100846,64, ,448,384
A,1,101294,88,s,84,-4
A,1,101378,73,t,207,134
A,1,101585,44,i,243,199
A,1,101828,20,l,114,94
A,1,101942,64,l,625,561
A,1,102567,47, ,381,334
A,1,102948,63,t,166,103
A,1,103114,65,h,180,115
A,1,103294,69,i,154,85
A,1,103448,68,n,144,76
A,1,103592,84,k,200,116
A,1,103792,60, ,404,344
A,1,104196,61,d,77,16
A,1,104273,64,i,205,141
A,1,104478,60,g,171,111
A,1,104649,71,i,227,156
A,1,104876,59,t,191,132
A,1,105067,104,a,96,-8
A,1,105163,56,l,544,488
A,1,105707,61, ,470,409
A,1,106177,116,w,258,142
A,1,106435,121,a,246,125
A,1,106681,82,t,170,88
A,1,106851,52,c,113,61
A,1,106964,52,h,204,152
A,1,107168,112,e,278,166
A,1,107446,92,s,622,530
A,1,108068,28, ,138,110
A,1,108206,112,a,208,96
A,1,108414,104,r,185,81
A,1,108599,80,e,96,16
A,1,108695,48, ,129,81
A,1,108824,120,a,108,-12
A,1,108932,40, ,725,685
A,1,109657,59,p,156,97
A,1,109813,73,r,281,208
A,1,110094,80,e,609,529
A,1,110703,40,t,132,92
A,1,110835,56,t,137,81
A,1,110972,85,y,198,113
A,1,111170,57, ,172,115
A,1,111342,48,n,142,94
A,1,111484,84,e,186,102
A,1,111670,163,a,124,-39
A,1,111794,60,t,308,248
A,1,112102,52, ,249,197
A,1,112351,63,i,115,52
A,1,112466,61,d,141,80
A,1,112607,77,e,173,96
A,1,112780,125,a,1355,1230
A,1,114135,32,.,1520,1488
A,1,115655,65,T,164,99
A,1,115819,60,h,160,100
A,1,115979,81,i,123,42
A,1,116102,72,s,68,-4
A,1,116170,68, ,277,209
A,1,116447,48,p,172,124
A,1,116619,65,l,1135,1070
A,1,117754,40,n,94,54
A,1,117848,76,e,140,64
A,1,117988,112,s,80,-32
A,1,118068,60,t,932,872
A,1,119000,132,a,198,66
A,1,119198,41,n,447,406
A,1,119645,96,e,117,21
A,1,119762,68,t,331,263
A,1,120093,28, ,933,905
A,1,121026,67, ,189,122
A,1,121215,48,h,107,59
A,1,121322,103,a,122,19
A,1,121444,88,s,155,67
A,1,121599,36,",",156,120
A,1,121755,36, ,196,160
A,1,121951,53,o,117,64
A,1,122068,64,r,110,46
A,1,122178,41, ,286,245
A,1,122464,73,r,184,111
A,1,122648,108,a,80,-28
A,1,122728,64,t,152,88
A,1,122880,73,h,77,4
A,1,122957,77,e,129,52
A,1,123086,72,r,112,40
A,1,123198,44, ,165,121
A,1,123363,64,h,127,63
A,1,123490,85,a,182,97
A,1,123672,76,d,198,122
A,1,123870,36,",",160,124
A,1,124030,44, ,136,92
A,1,124166,96,a,111,15
A,1,124277,44, ,441,397
A,1,124718,68,p,96,28
A,1,124814,84,r,98,14
A,1,124912,72,o,201,129
A,1,125113,40,b,746,706
A,1,125859,52,l,89,37
A,1,125948,72,e,84,12
A,1,126032,60,m,184,124
A,1,126216,41,",",139,98
A,1,126355,60, ,352,292
A,1,126707,76,w,99,23
A,1,126806,76,h,152,76
A,1,126958,76,i,20,-56
A,1,126978,68,c,154,86
A,1,127132,56,h,142,86
A,1,127274,92, ,203,111
A,1,127477,68,w,157,89
A,1,127634,108,a,116,8
A,1,127750,89,s,124,35
A,1,127874,100, ,404,304
A,1,128278,68,t,161,93
A,1,128439,56,h,155,99
A,1,128594,68,i,124,56
A,1,128718,64,s,449,385
A,1,129167,28,:,886,858
A,1,130053,60, ,159,99
A,1,130212,81,m,132,51
A,1,130344,60,o,156,96
A,1,130500,76,s,88,12
A,1,130588,60,t,169,109
A,1,130757,60, ,179,119
A,1,130936,56,o,140,84
A,1,131076,60,f,60,0
A,1,131136,64, ,160,96
A,1,131296,64,t,132,68
A,1,131428,68,h,91,23
A,1,131519,67,e,55,-12
A,1,131574,72, ,255,183
A,1,131829,68,p,249,181
A,1,132078,121,e,150,29
A,1,132228,48,o,114,66
A,1,132342,60,p,145,85
A,1,132487,68,l,137,69
A,1,132624,72,e,76,4
A,1,132700,64, ,187,123
A,1,132887,64,o,183,119
A,1,133070,45,n,119,74
A,1,133189,64, ,166,102
A,1,133355,73,i,130,57
A,1,133485,96,t,111,15
A,1,133596,68, ,381,313
A,1,133977,101,w,190,89
A,1,134167,80,e,137,57
A,1,134304,108,r,159,51
A,1,134463,88,e,102,14
A,1,134565,72, ,749,677
A,1,135314,64,n,221,157
A,1,135535,64,h,115,51
A,1,135650,124,a,240,116
A,1,135890,48,p,128,80
A,1,136018,56,p,299,243
A,1,136317,60,y,1400,1340
A,1,137717,56,y,546,490
A,1,138263,56,i,139,83
A,1,138402,72,n,281,209
A,1,138683,52,h,971,919
A,1,139654,57,u,148,91
A,1,139802,52,n,173,121
A,1,139975,69,h,126,57
A,1,140101,113,a,259,146
A,1,140360,48,p,120,72
A,1,140480,65,p,259,194
A,1,140739,57,y,1087,1030
A,1,141826,68, ,132,64
A,1,141958,77,f,89,12
A,1,142047,76,o,138,62
A,1,142185,60,r,128,68
A,1,142313,44, ,896,852
A,1,143209,64,p,115,51
A,1,143324,80,r,159,79
A,1,143483,112,e,294,182
A,1,143777,40,p,115,75
A,1,143892,51,p,270,219
A,1,144162,56,t,1024,968
A,1,145186,44,t,110,66
A,1,145296,64,t,156,92
A,1,145452,68,y,165,97
A,1,145617,68, ,405,337
A,1,146022,56,m,214,158
A,1,146236,64,u,692,628
A,1,146928,16,c,71,55
A,1,146999,60,h,651,591
A,1,147650,64, ,185,121
A,1,147835,64,o,100,36
A,1,147935,76,f,72,-4
A,1,148007,71, ,170,99
A,1,148177,64,t,137,73
A,1,148314,68,h,80,12
A,1,148394,80,e,67,-13
A,1,148461,89, ,245,156
A,1,148706,72,t,190,118
A,1,148896,76,i,167,91
A,1,149063,88,m,106,18
A,1,149169,118,e,206,88
A,1,149375,16,",",761,745
A,1,150136,40,.,206,166
A,1,150342,48, ,217,169
A,1,150559,56,M,342,286
A,1,150901,119,a,132,13
A,1,151033,48,n,180,132
A,1,151213,65,y,212,147
A,1,151425,76, ,413,337
A,1,151838,100,s,130,30
A,1,151968,68,o,194,126
A,1,152162,40,u,156,116
A,1,152318,44,l,233,189
A,1,152551,52,t,230,178
A,1,152781,52,i,931,879
A,1,153712,44,l,244,200
A,1,153956,44,i,769,725
A,1,154725,44,u,180,136
A,1,154905,27,t,535,508
A,1,155440,60,i,175,115
A,1,155615,68,o,186,118
A,1,155801,40,n,132,92
A,1,155933,72,s,88,16
A,1,156021,48, ,1424,1376
A,1,157445,92,w,166,74
A,1,157611,92,e,162,70
A,1,157773,96,r,142,46
A,1,157915,112,e,108,-4
A,1,158023,64, ,376,312
A,1,158399,100,s,153,53
A,1,158552,56,u,229,173
A,1,158781,44,g,120,76
A,1,158901,64,g,85,21
A,1,158986,80,e,131,51
A,1,159117,108,s,79,-29
A,1,159196,64,t,181,117
A,1,159377,108,e,409,301
A,1,159786,88,d,110,22
A,1,159896,76, ,434,358
A,1,160330,92,f,119,27
A,1,160449,80,o,255,175
A,1,160704,96,r,175,79
A,1,160879,72, ,202,130
A,1,161081,64,t,143,79
A,1,161224,52,g,191,139
A,1,161415,56,i,100,44
A,1,161515,69,s,1009,940
A,1,162524,48,h,134,86
A,1,162658,64,i,95,31
A,1,162753,80,s,105,25
A,1,162858,32, ,497,465
A,1,163355,52,p,98,46
A,1,163453,79,r,76,-3
A,1,163529,63,o,175,112
A,1,163704,52,b,156,104
A,1,163860,80,l,116,36
A,1,163976,77,e,103,26
A,1,164079,113,m,1584,1471
A,1,165663,48,",",136,88
A,1,165799,56, ,158,102
A,1,165957,63,b,155,92
A,1,166112,56,u,218,162
A,1,166330,64,t,180,116
A,1,166510,72, ,496,424
A,1,167006,68,m,154,86
A,1,167160,60,o,154,94
A,1,167314,89,s,96,7
A,1,167410,73,t,164,91
A,1,167574,76, ,179,103
A,1,167753,85,o,141,56
A,1,167894,76,f,72,-4
A,1,167966,76, ,278,202
A,1,168244,76,t,166,90
A,1,168410,81,h,378,297
A,1,168788,112,e,238,126
A,1,169026,72,s,166,94
A,1,169192,88,e,123,35
A,1,169315,76, ,228,152
A,1,169543,81,w,189,108
A,1,169732,97,e,173,76
A,1,169905,76,r,156,80
A,1,170061,108,e,119,11
A,1,170180,73, ,244,171
A,1,170424,60,l,98,38
A,1,170522,97,a,202,105
A,1,170724,68,r,114,46
A,1,170838,64,g,112,48
A,1,170950,72,e,154,82
A,1,171104,56,l,232,176
A,1,171336,61,y,872,811
A,1,172208,28, ,203,175
A,1,172411,68,c,103,35
A,1,172514,61,o,168,107
A,1,172682,43,n,295,252
A,1,172977,73,c,193,120
A,1,173170,97,e,161,64
A,1,173331,80,r,153,73
A,1,173484,64,n,137,73
A,1,173621,80,e,175,95
A,1,173796,84,d,135,51
A,1,173931,56, ,182,126
A,1,174113,79,w,107,28
A,1,174220,57,i,239,182
A,1,174459,55,t,151,96
A,1,174610,65,h,209,144
A,1,174819,60, ,273,213
A,1,175092,56,t,161,105
A,1,175253,36,h,51,15
A,1,175304,77,e,273,196
A,1,175577,69, ,536,467
A,1,176113,77,m,159,82
A,1,176272,68,o,313,245
A,1,176585,64,e,632,568
A,1,177217,60,v,91,31
A,1,177308,72,e,86,14
A,1,177394,69,n,605,536
A,1,177999,68,m,141,73
A,1,178140,89,e,69,-20
A,1,178209,80,n,220,140
A,1,178429,69,t,158,89
A,1,178587,65,s,68,3
A,1,178655,73, ,757,684
A,1,179412,80,f,563,483
A,1,179975,84,o,169,85
A,1,180144,80,f,84,4
A,1,180228,48, ,190,142
A,1,180418,68,s,132,64
A,1,180550,61,m,143,82
A,1,180693,111,a,103,-8
A,1,180796,73,l,566,493
A,1,181362,64,l,438,374
A,1,181800,32, ,289,257
A,1,182089,48,g,121,73
A,1,182210,108,r,319,211
A,1,182529,61,e,142,81
A,1,182671,76,e,138,62
A,1,182809,65,n,168,103
A,1,182977,81, ,230,149
A,1,183207,124,p,438,314
A,1,183645,109,i,281,172
A,1,183926,68,e,223,155
A,1,184149,84,c,269,185
A,1,184418,88,e,222,134
A,1,184640,68,s,191,123
A,1,184831,64, ,235,171
A,1,185066,64,p,237,173
A,1,185303,88,f,841,753
A,1,186144,76,o,124,48
A,1,186268,71,f,83,12
A,1,186351,73, ,772,699
A,1,187123,76,p,224,148
A,1,187347,80,a,80,0
A,1,187427,56,p,146,90
A,1,187573,80,e,163,83
A,1,187736,73,r,101,28
A,1,187837,45,",",261,216
A,1,188098,121, ,605,484
A,1,188703,67,w,59,-8
A,1,188762,73,h,128,55
A,1,188890,96,i,48,-48
A,1,188938,73,c,112,39
A,1,189050,69,h,146,77
A,1,189196,69, ,139,70
A,1,189335,93,i,150,57
A,1,189485,91,s,71,-20
A,1,189556,77, ,590,513
A,1,190146,67,o,182,115
A,1,190328,61,d,140,79
A,1,190468,81,d,132,51
A,1,190600,72, ,205,133
A,1,190805,72,b,104,32
A,1,190909,72,e,188,116
A,1,191097,109,c,188,79
A,1,191285,115,a,104,-11
A,1,191389,72,u,109,37
A,1,191498,89,s,155,66
A,1,191653,93,e,162,69
A,1,191815,81, ,208,127
A,1,192023,68,o,163,95
A,1,192186,60,n,146,86
A,1,192332,53, ,168,115
A,1,192500,65,t,144,79
A,1,192644,85,h,129,44
A,1,192773,84,e,80,-4
A,1,192853,80, ,178,98
A,1,193031,68,w,35,-33
A,1,193066,73,h,173,100
A,1,193239,89,o,206,117
A,1,193445,96,l,568,472
A,1,194013,77,e,138,61
A,1,194151,89, ,184,95
A,1,194335,107,i,203,96
A,1,194538,108,t,176,68
A,1,194714,69, ,247,178
A,1,194961,97,w,194,97
A,1,195155,123,a,141,18
A,1,195296,101,s,199,98
A,1,195495,61,n,563,502
A,1,196058,40,',248,208
A,1,196306,72,t,257,185
A,1,196563,68, ,225,157
A,1,196788,73,t,149,76
A,1,196937,76,h,84,8
A,1,197021,89,e,106,17
A,1,197127,69, ,209,140
A,1,197336,73,s,132,59
A,1,197468,116,a,116,0
A,1,197584,61,m,1393,1332
A,1,198977,68,m,2335,2267
A,1,201312,56,a,280,224
A,1,201592,45,l,128,83
A,1,201720,57,l,227,170
A,1,201947,68, ,763,695
A,1,202710,56,g,100,44
A,1,202810,101,r,290,189
A,1,203100,53,e,145,92
A,1,203245,57,e,141,84
A,1,203386,65,n,151,86
A,1,203537,65, ,235,170
A,1,203772,76,p,364,288
A,1,204136,88,i,234,146
A,1,204370,60,e,222,162
A,1,204592,65,c,233,168
A,1,204825,89,e,210,121
A,1,205035,77,s,176,99
A,1,205211,77, ,196,119
A,1,205407,61,p,133,72
A,1,205540,77,f,138,61
A,1,205678,44, ,840,796
A,1,206518,59,o,98,39
A,1,206616,73,f,96,23
A,1,206712,64, ,307,243
A,1,207019,56,p,111,55
A,1,207130,92,a,64,-28
A,1,207194,64,p,171,107
A,1,207365,80,e,151,71
A,1,207516,73,r,113,40
A,1,207629,48, ,298,250
A,1,207927,65,t,125,60
A,1,208052,87,h,91,4
A,1,208143,109,a,89,-20
A,1,208232,64,t,174,110
A,1,208406,59, ,250,191
A,1,208656,105,w,180,75
A,1,208836,109,e,153,44
A,1,208989,88,r,148,60
A,1,209137,100,e,92,-8
A,1,209229,65, ,248,183
A,1,209477,80,u,177,97
A,1,209654,67,n,221,154
A,1,209875,72,h,160,88
A,1,210035,73,a,293,220
A,1,210328,40,p,139,99
A,1,210467,49,p,283,234
A,1,210750,47,y,2928,2881
A,1,213678,56,.,NA,NA
A,2,107,69,M,189,120
A,2,296,36,y,4,-32
A,2,300,28,u,139,111
A,2,439,76, ,1262,1186
A,2,1701,64, ,508,444
A,2,2209,88,f,198,110
A,2,2407,111,a,262,151
A,2,2669,57,v,206,149
A,2,2875,76,i,802,726
A,2,3677,69,o,122,53
A,2,3799,72,r,407,335
A,2,4206,57,i,2544,2487
A,2,6750,68,t,121,53
A,2,6871,80,e,60,-20
A,2,6931,80, ,370,290
A,2,7301,77,f,121,44
A,2,7422,57,o,143,86
A,2,7565,56,o,136,80
A,2,7701,84,d,105,21
A,2,7806,57, ,171,114
A,2,7977,64,i,101,37
A,2,8078,100,s,92,-8
A,2,8170,64, ,21472,21408
A,2,29642,35,t,320,285
A,2,29962,72,o,2240,2168
A,2,32202,44,m,3889,3845
A,2,36091,53,i,527,474
A,2,36618,69,f,114,45
A,2,36732,68,i,162,94
A,2,36894,81,s,85,4
A,2,36979,44,h,1212,1168
A,2,38191,68,f,410,342
A,2,38601,73,d,117,44
A,2,38718,37,i,159,122
A,2,38877,60,s,604,544
A,2,39481,56,h,185,129
A,2,39666,64, ,190,126
A,2,39856,67,i,151,84
A,2,40007,56,s,76,20
A,2,40083,60, ,5746,5686
A,2,45829,49, ,222,173
A,2,46051,88,f,102,14
A,2,46153,64,o,138,74
A,2,46291,76,o,117,41
A,2,46408,103,d,159,56
A,2,46567,32, ,185,153
A,2,46752,68,i,121,53
A,2,46873,76,s,95,19
A,2,46968,64, ,3592,3528
A,2,50560,164,f,176,12
A,2,50736,116,r,76,-40
A,2,50812,72,i,202,130
A,2,51014,72,e,157,85
A,2,51171,72,d,96,24
A,2,51267,60, ,802,742
A,2,52069,64,t,225,161
A,2,52294,61,o,181,120
A,2,52475,40,m,109,69
A,2,52584,104,a,1291,1187
A,2,53875,72,t,708,636
A,2,54583,44,o,408,364
A,2,54991,60, ,872,812
A,2,55863,112,w,80,-32
A,2,55943,44,i,180,136
A,2,56123,60,t,140,80
A,2,56263,68,h,147,79
A,2,56410,78, ,949,871
A,2,57359,75,e,537,462
A,2,57896,40,g,117,77
A,2,58013,65,g,184,119
A,2,58197,105,s,300,195
A,2,58497,23,.,151,128
A,2,58648,52, ,1444,1392
A,2,60092,65,I,1103,1038
A,2,61195,60,t,156,96
A,2,61351,88, ,183,95
A,2,61534,68,i,110,42
A,2,61644,80,s,68,-12
A,2,61712,84, ,236,152
A,2,61948,96,a,88,-8
A,2,62036,36, ,500,464
A,2,62536,57,t,95,38
A,2,62631,80,r,217,137
A,2,62848,65,a,146,81
A,2,62994,69,d,131,62
A,2,63125,68,i,220,152
A,2,63345,56,t,224,168
A,2,63569,60,i,122,62
A,2,63691,60,o,157,97
A,2,63848,72,n,144,72
A,2,63992,105,a,88,-17
A,2,64080,69,l,200,131
A,2,64280,64, ,1619,1555
A,2,65899,64,C,194,130
A,2,66093,80,h,134,54
A,2,66227,80,i,156,76
A,2,66383,76,n,102,26
A,2,66485,88,e,184,96
A,2,66669,72,s,139,67
A,2,66808,101,e,126,25
A,2,66934,68, ,1492,1424
A,2,68426,84,d,87,3
A,2,68513,65,i,151,86
A,2,68664,77,s,80,3
A,2,68744,49,h,2532,2483
A,2,71276,44, ,131,87
A,2,71407,77,a,110,33
A,2,71517,36,n,93,57
A,2,71610,76,d,99,23
A,2,71709,64, ,429,365
A,2,72138,52,i,132,80
A,2,72270,99,t,60,-39
A,2,72330,60, ,201,141
A,2,72531,56,i,230,174
A,2,72761,96,s,113,17
A,2,72874,64, ,1051,987
A,2,73925,51,v,96,45
A,2,74021,76,e,150,74
A,2,74171,71,r,51,-20
A,2,74222,61,y,229,168
A,2,74451,52, ,4984,4932
A,2,79435,71,e,218,147
A,2,79653,88,s,579,491
A,2,80232,127,a,120,-7
A,2,80352,108,s,121,13
A,2,80473,85,y,194,109
A,2,80667,80, ,285,205
A,2,80952,85,t,92,7
A,2,81044,73,o,210,137
A,2,81254,56, ,485,429
A,2,81739,69,c,89,20
A,2,81828,60,o,132,72
A,2,81960,61,o,194,133
A,2,82154,40,k,475,435
A,2,82629,36,.,7727,7691
A,2,90356,60,.,216,156
A,2,90572,44, ,245,201
A,2,90817,63,i,235,172
A,2,91052,64, ,1140,1076
A,2,92192,81,I,189,108
A,2,92381,76, ,184,108
A,2,92565,69,l,157,88
A,2,92722,65,o,254,189
A,2,92976,60,v,108,48
A,2,93084,68,e,55,-13
A,2,93139,85, ,530,445
A,2,93669,60,i,67,7
A,2,93736,92,t,465,373
A,2,94201,61, ,197,136
A,2,94398,64,b,88,24
A,2,94486,76,e,214,138
A,2,94700,77,c,212,135
A,2,94912,96,a,79,-17
A,2,94991,65,u,113,48
A,2,95104,89,s,160,71
A,2,95264,117,e,2086,1969
A,2,97350,43, ,167,124
A,2,97517,95,a,115,20
A,2,97632,49,n,93,44
A,2,97725,61,d,100,39
A,2,97825,53, ,562,509
A,2,98387,72,i,109,37
A,2,98496,81,t,94,13
A,2,98590,80, ,294,214
A,2,98884,57,t,136,79
A,2,99020,136,a,132,-4
A,2,99152,152,s,141,-11
A,2,99293,48,k,850,802
A,2,100143,44,t,924,880
A,2,101067,108,s,116,8
A,2,101183,64,t,404,340
A,2,101587,65,e,141,76
A,2,101728,96,s,93,-3
A,2,101821,84, ,706,622
A,2,102527,88,r,150,62
A,2,102677,109,e,197,88
A,2,102874,96,a,100,4
A,2,102974,41,l,125,84
A,2,103099,57,l,209,152
A,2,103308,56,y,178,122
A,2,103486,68, ,209,141
A,2,103695,52,g,185,133
A,2,103880,64,o,123,59
A,2,104003,72,o,150,78
A,2,104153,68,d,313,245
A,2,104466,37,.,NA,NA
B,1,918,96,F,192,96
B,1,1110,84,a,135,51
B,1,1245,109,r,242,133
B,1,1487,64, ,146,82
B,1,1633,116,o,269,153
B,1,1902,91,u,175,84
B,1,2077,96,t,140,44
B,1,2217,72, ,52,-20
B,1,2269,84,i,99,15
B,1,2368,116,n,735,619
B,1,3103,82, ,278,196
B,1,3381,106,t,80,-26
B,1,3461,84,h,199,115
B,1,3660,141,e,112,-29
B,1,3772,93, ,141,48
B,1,3913,44,u,133,89
B,1,4046,116,n,168,52
B,1,4214,128,c,117,-11
B,1,4331,60,h,103,43
B,1,4434,125,a,194,69
B,1,4628,115,r,207,92
B,1,4835,97,t,184,87
B,1,5019,97,e,187,90
B,1,5206,104,d,18538,18434
B,1,23744,62, ,253,191
B,1,23997,76,b,87,11
B,1,24084,97,a,159,62
B,1,24243,72,c,32,-40
B,1,24275,80,k,185,105
B,1,24460,88,w,174,86
B,1,24634,119,a,233,114
B,1,24867,105,t,184,79
B,1,25051,88,e,124,36
B,1,25175,85,r,166,81
B,1,25341,96,s,102,6
B,1,25443,66, ,93,27
B,1,25536,122,o,53,-69
B,1,25589,81,f,95,14
B,1,25684,73, ,113,40
B,1,25797,83,t,79,-4
B,1,25876,125,h,88,-37
B,1,25964,51,e,48,-3
B,1,26012,89, ,92,3
B,1,26104,65,u,95,30
B,1,26199,113,n,133,20
B,1,26332,108,f,222,114
B,1,26554,133,a,278,145
B,1,26832,112,s,198,86
B,1,27030,88,h,161,73
B,1,27191,64,i,154,90
B,1,27345,84,o,111,27
B,1,27456,69,n,96,27
B,1,27552,125,a,73,-52
B,1,27625,36,l,619,583
B,1,28244,88,b,177,89
B,1,28421,76,l,117,41
B,1,28538,113,e,131,18
B,1,28669,81, ,822,741
B,1,29491,108,e,159,51
B,1,29650,71,n,75,4
B,1,29725,121,d,150,29
B,1,29875,86, ,85,-1
B,1,29960,83,o,55,-28
B,1,30015,104,f,116,12
B,1,30131,69, ,157,88
B,1,30288,95,t,107,12
B,1,30395,81,h,113,32
B,1,30508,104,e,101,-3
B,1,30609,80, ,126,46
B,1,30735,32,w,116,84
B,1,30851,93,e,178,85
B,1,31029,69,s,190,121
B,1,31219,76,t,154,78
B,1,31373,68,e,143,75
B,1,31516,116,r,52,-64
B,1,31568,101,n,139,38
B,1,31707,86, ,196,110
B,1,31903,100,s,67,-33
B,1,31970,85,p,185,100
B,1,32155,83,i,84,1
B,1,32239,116,r,115,-1
B,1,32354,117,a,73,-44
B,1,32427,109,l,79,-30
B,1,32506,89, ,137,48
B,1,32643,112,a,191,79
B,1,32834,118,r,79,-39
B,1,32913,124,m,176,52
B,1,33089,72, ,84,12
B,1,33173,97,o,57,-40
B,1,33230,100,f,118,18
B,1,33348,60, ,105,45
B,1,33453,97,t,96,-1
B,1,33549,53,h,98,45
B,1,33647,140,e,128,-12
B,1,33775,81, ,142,61
B,1,33917,93,g,177,84
B,1,34094,44,a,235,191
B,1,34329,124,l,142,18
B,1,34471,129,a,675,546
B,1,35146,128,x,243,115
B,1,35389,104,p,762,658
B,1,36151,34,t,1670,1636
B,1,37821,136,y,220,84
B,1,38041,96, ,243,147
B,1,38284,80,l,179,99
B,1,38463,80,i,144,64
B,1,38607,112,e,226,114
B,1,38833,101,s,135,34
B,1,38968,81, ,95,14
B,1,39063,93,a,123,30
B,1,39186,81, ,115,34
B,1,39301,125,s,104,-21
B,1,39405,93,m,92,-1
B,1,39497,97,a,111,14
B,1,39608,81,l,123,42
B,1,39731,132,l,711,579
B,1,40442,72, ,145,73
B,1,40587,89,u,187,98
B,1,40774,65,n,133,68
B,1,40907,97,r,182,85
B,1,41089,121,e,277,156
B,1,41366,89,g,191,102
B,1,41557,120,a,166,46
B,1,41723,112,r,196,84
B,1,41919,95,d,173,78
B,1,42092,93,e,179,86
B,1,42271,88,d,198,110
B,1,42469,65, ,644,579
B,1,43113,116,y,256,140
B,1,43369,80,e,33,-47
B,1,43402,63,l,139,76
B,1,43541,90,l,212,122
B,1,43753,88,o,100,12
B,1,43853,105,w,120,15
B,1,43973,77, ,138,61
B,1,44111,116,s,104,-12
B,1,44215,77,u,178,101
B,1,44393,97,n,319,222
B,1,44712,104,.,2282,2178
B,1,46994,108,O,223,115
B,1,47217,137,r,369,232
B,1,47586,65,b,112,47
B,1,47698,108,i,179,71
B,1,47877,126,t,100,-26
B,1,47977,84,i,113,29
B,1,48090,88,n,52,-36
B,1,48142,108,g,139,31
B,1,48281,72, ,80,8
B,1,48361,112,t,68,-44
B,1,48429,48,h,84,36
B,1,48513,95,i,88,-7
B,1,48601,104,s,88,-16
B,1,48689,96, ,135,39
B,1,48824,116,a,244,128
B,1,49068,112,t,149,37
B,1,49217,73, ,97,24
B,1,49314,88,a,100,12
B,1,49414,77, ,145,68
B,1,49559,105,d,123,18
B,1,49682,88,i,64,-24
B,1,49746,101,s,202,101
B,1,49948,96,t,107,11
B,1,50055,124,a,117,-7
B,1,50172,77,n,123,46
B,1,50295,108,c,238,130
B,1,50533,52,e,59,7
B,1,50592,81, ,267,186
B,1,50859,124,o,107,-17
B,1,50966,108,f,126,18
B,1,51092,88, ,224,136
B,1,51316,100,r,84,-16
B,1,51400,68,o,202,134
B,1,51602,80,u,87,7
B,1,51689,129,g,204,75
B,1,51893,88,h,233,145
B,1,52126,104,l,223,119
B,1,52349,88,y,162,74
B,1,52511,64, ,1187,1123
B,1,53698,48,n,290,242
B,1,53988,157,i,1448,1291
B,1,55436,109, ,283,174
B,1,55719,88, ,4023,3935
B,1,59742,89, ,185,96
B,1,59927,84,n,689,605
B,1,60616,128,i,190,62
B,1,60806,120,n,222,102
B,1,61028,124,e,216,92
B,1,61244,136,t,143,7
B,1,61387,101,y,1340,1239
B,1,62727,108,t,1436,1328
B,1,64163,56,t,190,134
B,1,64353,96,w,123,27
B,1,64476,72,o,248,176
B,1,64724,96, ,344,248
B,1,65068,100,m,165,65
B,1,65233,80,i,178,98
B,1,65411,60,l,134,74
B,1,65545,100,l,220,120
B,1,65765,68,i,139,71
B,1,65904,79,o,76,-3
B,1,65980,97,n,134,37
B,1,66114,60, ,97,37
B,1,66211,72,m,153,81
B,1,66364,61,i,133,72
B,1,66497,95,l,91,-4
B,1,66588,109,e,187,78
B,1,66775,96,s,80,-16
B,1,66855,97, ,132,35
B,1,66987,88,i,249,161
B,1,67236,104,s,138,34
B,1,67374,57, ,595,538
B,1,67969,72,s,462,390
B,1,68431,60, ,129,69
B,1,68560,128,a,72,-56
B,1,68632,120,n,158,38
B,1,68790,48, ,133,85
B,1,68923,92,u,181,89
B,1,69104,80,t,168,88
B,1,69272,40,t,250,210
B,1,69522,117,r,614,497
B,1,70136,104,e,168,64
B,1,70304,176,r,92,-84
B,1,70396,96,l,233,137
B,1,70629,100,y,137,37
B,1,70766,119, ,68,-51
B,1,70834,119,i,115,-4
B,1,70949,101,n,166,65
B,1,71115,104,s,224,120
B,1,71339,127,i,119,-8
B,1,71458,97,g,220,123
B,1,71678,113,f,141,28
B,1,71819,94,n,159,65
B,1,71978,128,i,1107,979
B,1,73085,125,n,209,84
B,1,73294,100,i,132,32
B,1,73426,99,f,107,8
B,1,73533,126,i,125,-1
B,1,73658,92,c,108,16
B,1,73766,141,a,97,-44
B,1,73863,71,n,136,65
B,1,73999,101,t,150,49
B,1,74149,72, ,343,271
B,1,74492,27,i,665,638
B,1,75157,100,l,213,113
B,1,75370,88,i,125,37
B,1,75495,61,t,141,80
B,1,75636,125,t,109,-16
B,1,75745,88,l,127,39
B,1,75872,91,e,88,-3
B,1,75960,72, ,115,43
B,1,76075,89,b,142,53
B,1,76217,88,l,193,105
B,1,76410,80,u,72,-8
B,1,76482,124,e,108,-16
B,1,76590,76, ,353,277
B,1,76943,91,g,340,249
B,1,77283,129,r,210,81
B,1,77493,99,e,162,63
B,1,77655,116,e,60,-56
B,1,77715,103,n,129,26
B,1,77844,120, ,112,-8
B,1,77956,72,p,184,112
B,1,78140,92,l,103,11
B,1,78243,124,a,121,-3
B,1,78364,44,n,276,232
B,1,78640,128,e,197,69
B,1,78837,104,t,133,29
B,1,78970,97, ,240,143
B,1,79210,136,w,3,-133
B,1,79213,61,h,252,191
B,1,79465,123,o,112,-11
B,1,79577,88,s,179,91
B,1,79756,93,e,121,28
B,1,79877,73, ,90,17
B,1,79967,113,a,113,0
B,1,80080,99,p,212,113
B,1,80292,140,e,445,305
B,1,80737,117,d,217,100
B,1,80954,100,e,209,109
B,1,81163,69,s,241,172
B,1,81404,120,c,232,112
B,1,81636,108,e,115,7
B,1,81751,118,n,125,7
B,1,81876,105,d,189,84
B,1,82065,91,e,166,75
B,1,82231,136,d,197,61
B,1,82428,96, ,24,-72
B,1,82452,75,l,161,86
B,1,82613,104,i,44,-60
B,1,82657,116,f,191,75
B,1,82848,105,e,84,-21
B,1,82932,92, ,120,28
B,1,83052,113,f,131,18
B,1,83183,112,o,97,-15
B,1,83280,107,r,88,-19
B,1,83368,115,m,277,162
B,1,83645,120,s,131,11
B,1,83776,77, ,80,3
B,1,83856,101,a,153,52
B,1,84009,103,r,176,73
B,1,84185,117,e,92,-25
B,1,84277,84, ,120,36
B,1,84397,88,s,85,-3
B,1,84482,103,o,151,48
B,1,84633,104, ,204,100
B,1,84837,120,a,131,11
B,1,84968,101,m,169,68
B,1,85137,129,a,242,113
B,1,85379,116,z,88,-28
B,1,85467,83,o,526,443
B,1,85993,112,i,127,15
B,1,86120,112,n,76,-36
B,1,86196,104,g,190,86
B,1,86386,108,l,248,140
B,1,86634,116,y,213,97
B,1,86847,89, ,486,397
B,1,87333,88,p,122,34
B,1,87455,127,r,88,-39
B,1,87543,83,i,220,137
B,1,87763,56,m,182,126
B,1,87945,125,i,152,27
B,1,88097,140,t,205,65
B,1,88302,119,i,127,8
B,1,88429,89,v,193,104
B,1,88622,131,e,96,-35
B,1,88718,81, ,127,46
B,1,88845,110,t,83,-27
B,1,88928,75,h,72,-3
B,1,89000,89,a,91,2
B,1,89091,126,t,126,0
B,1,89217,99, ,256,157
B,1,89473,96,t,88,-8
B,1,89561,81,h,100,19
B,1,89661,136,e,124,-12
B,1,89785,65,y,97,32
B,1,89882,73, ,424,351
B,1,90306,120,s,241,121
B,1,90547,120,t,84,-36
B,1,90631,72,i,292,220
B,1,90923,116,l,184,68
B,1,91107,60,l,173,113
B,1,91280,68, ,108,40
B,1,91388,132,t,72,-60
B,1,91460,64,h,92,28
B,1,91552,89,i,122,33
B,1,91674,93,n,107,14
B,1,91781,146,k,201,55
B,1,91982,68, ,2294,2226
B,1,94276,109, ,4207,4098
B,1,98483,114,d,103,-11
B,1,98586,121,i,244,123
B,1,98830,116,g,117,1
B,1,98947,111,i,188,77
B,1,99135,116,t,510,394
B,1,99645,140,a,112,-28
B,1,99757,89,l,152,63
B,1,99909,81, ,177,96
B,1,100086,137,w,219,82
B,1,100305,112,a,204,92
B,1,100509,88,t,234,146
B,1,100743,112,c,80,-32
B,1,100823,112,h,995,883
B,1,101818,101,e,178,77
B,1,101996,112,s,115,3
B,1,102111,90, ,103,13
B,1,102214,105,a,201,96
B,1,102415,120,r,194,74
B,1,102609,115,e,108,-7
B,1,102717,87, ,84,-3
B,1,102801,119,a,116,-3
B,1,102917,80, ,176,96
B,1,103093,120,p,123,3
B,1,103216,113,r,199,86
B,1,103415,108,e,173,65
B,1,103588,125,t,138,13
B,1,103726,81,y,545,464
B,1,104271,139,t,136,-3
B,1,104407,92,y,188,96
B,1,104595,112, ,148,36
B,1,104743,129,n,168,39
B,1,104911,88,e,2364,2276
B,1,107275,161,n,149,-12
B,1,107424,156,e,195,39
B,1,107619,139,a,170,31
B,1,107789,133,t,160,27
B,1,107949,97, ,254,157
B,1,108203,94, ,923,829
B,1,109126,89, ,178,89
B,1,109304,109, ,1190,1081
B,1,110494,84, ,127,43
B,1,110621,95,i,80,-15
B,1,110701,96,d,173,77
B,1,110874,115,e,128,13
B,1,111002,100,a,1174,1074
B,1,112176,92, ,1680,1588
B,1,113856,141,.,2448,2307
B,1,116304,132,T,89,-43
B,1,116393,47,h,101,54
B,1,116494,119,i,108,-11
B,1,116602,96,s,99,3
B,1,116701,94, ,586,492
B,1,117287,101,p,185,84
B,1,117472,120,l,80,-40
B,1,117552,120,a,138,18
B,1,117690,88,n,176,88
B,1,117866,140,e,628,488
B,1,118494,124,t,11145,11021
B,1,129639,96, ,1448,1352
B,1,131087,100, ,814,714
B,1,131901,104, ,360,256
B,1,132261,100,h,75,-25
B,1,132336,101,a,151,50
B,1,132487,125,s,271,146
B,1,132758,157,",",184,27
B,1,132942,105, ,121,16
B,1,133063,100,o,115,15
B,1,133178,129,r,188,59
B,1,133366,65, ,112,47
B,1,133478,131,r,139,8
B,1,133617,120,a,122,2
B,1,133739,98,t,70,-28
B,1,133809,88,h,100,12
B,1,133909,97,e,139,42
B,1,134048,104,r,168,64
B,1,134216,92, ,113,21
B,1,134329,92,h,96,4
B,1,134425,121,a,190,69
B,1,134615,105,d,173,68
B,1,134788,105,",",193,88
B,1,134981,84, ,141,57
B,1,135122,96,a,208,112
B,1,135330,93, ,194,101
B,1,135524,93,p,133,40
B,1,135657,108,r,100,-8
B,1,135757,129,o,191,62
B,1,135948,72,b,147,75
B,1,136095,136,l,151,15
B,1,136246,128,e,72,-56
B,1,136318,88,m,282,194
B,1,136600,100,",",942,842
B,1,137542,97, ,186,89
B,1,137728,129,w,108,-21
B,1,137836,53,h,95,42
B,1,137931,124,i,127,3
B,1,138058,133,c,116,-17
B,1,138174,93,h,115,22
B,1,138289,64, ,307,243
B,1,138596,109,w,132,23
B,1,138728,113,a,128,15
B,1,138856,101,s,121,20
B,1,138977,101, ,257,156
B,1,139234,136,t,108,-28
B,1,139342,57,h,89,32
B,1,139431,104,i,129,25
B,1,139560,133,s,213,80
B,1,139773,85, ,601,516
B,1,140374,69,:,114,45
B,1,140488,89, ,137,48
B,1,140625,89,m,146,57
B,1,140771,104,o,72,-32
B,1,140843,84,s,179,95
B,1,141022,112,t,113,1
B,1,141135,55, ,62,7
B,1,141197,81,o,186,105
B,1,141383,96, ,397,301
B,1,141780,99,f,95,-4
B,1,141875,77, ,116,39
B,1,141991,93,t,114,21
B,1,142105,88,h,52,-36
B,1,142157,99,e,96,-3
B,1,142253,84, ,129,45
B,1,142382,81,p,96,15
B,1,142478,124,e,85,-39
B,1,142563,66,o,150,84
B,1,142713,93,p,183,90
B,1,142896,108,l,44,-64
B,1,142940,96,e,113,17
B,1,143053,90, ,104,14
B,1,143157,89,o,108,19
B,1,143265,92,n,20,-72
B,1,143285,88, ,133,45
B,1,143418,116,i,96,-20
B,1,143514,103,t,96,-7
B,1,143610,76, ,133,57
B,1,143743,97,w,164,67
B,1,143907,132,e,204,72
B,1,144111,61,r,119,58
B,1,144230,101,e,257,156
B,1,144487,100, ,114,14
B,1,144601,73,u,112,39
B,1,144713,105,n,168,63
B,1,144881,68,c,52,-16
B,1,144933,72,h,1038,966
B,1,145971,116,h,183,67
B,1,146154,89,a,195,106
B,1,146349,104,p,166,62
B,1,146515,80,p,181,101
B,1,146696,85,y,113,28
B,1,146809,85, ,174,89
B,1,146983,164,f,208,44
B,1,147191,68,o,105,37
B,1,147296,120,r,123,3
B,1,147419,66, ,97,31
B,1,147516,117,p,182,65
B,1,147698,129,r,157,28
B,1,147855,116,e,198,82
B,1,148053,72,t,138,66
B,1,148191,116,t,235,119
B,1,148426,96,y,160,64
B,1,148586,92, ,118,26
B,1,148704,88,m,198,110
B,1,148902,91,u,99,8
B,1,149001,112,c,64,-48
B,1,149065,92,h,126,34
B,1,149191,78, ,77,-1
B,1,149268,102,o,68,-34
B,1,149336,101,f,120,19
B,1,149456,73, ,329,256
B,1,149785,104,t,125,21
B,1,149910,134,h,225,91
B,1,150135,120,e,441,321
B,1,150576,112, ,151,39
B,1,150727,115,t,64,-51
B,1,150791,116,i,158,42
B,1,150949,140,m,128,-12
B,1,151077,108,e,203,95
B,1,151280,124,.,151,27
B,1,151431,81, ,221,140
B,1,151652,56,M,200,144
B,1,151852,97,a,64,-33
B,1,151916,113,n,264,151
B,1,152180,76,y,115,39
B,1,152295,88, ,194,106
B,1,152489,120,s,40,-80
B,1,152529,121,o,180,59
B,1,152709,92,l,198,106
B,1,152907,60,u,67,7
B,1,152974,33,i,49,16
B,1,153023,125,t,1115,990
B,1,154138,65,t,203,138
B,1,154341,108,i,156,48
B,1,154497,131,o,116,-15
B,1,154613,116,n,80,-36
B,1,154693,120,s,124,4
B,1,154817,76, ,96,20
B,1,154913,96,w,147,51
B,1,155060,121,e,194,73
B,1,155254,104,r,165,61
B,1,155419,131,e,104,-27
B,1,155523,65, ,97,32
B,1,155620,96,s,93,-3
B,1,155713,75,u,104,29
B,1,155817,57,g,152,95
B,1,155969,148,g,256,108
B,1,156225,77,e,147,70
B,1,156372,88,s,197,109
B,1,156569,100,t,168,68
B,1,156737,109,e,237,128
B,1,156974,125,d,144,19
B,1,157118,95, ,110,15
B,1,157228,104,f,229,125
B,1,157457,152,o,873,721
B,1,158330,101,o,134,33
B,1,158464,109,r,145,36
B,1,158609,101, ,130,29
B,1,158739,125,t,93,-32
B,1,158832,76,h,101,25
B,1,158933,125,i,72,-53
B,1,159005,157,s,169,12
B,1,159174,92, ,104,12
B,1,159278,80,p,150,70
B,1,159428,124,r,51,-73
B,1,159479,96,o,146,50
B,1,159625,85,b,164,79
B,1,159789,116,l,163,47
B,1,159952,124,e,111,-13
B,1,160063,89,m,274,185
B,1,160337,88,.,458,370
B,1,160795,108, ,610,502
B,1,161405,100,",",122,22
B,1,161527,105, ,284,179
B,1,161811,108,b,296,188
B,1,162107,116,u,128,12
B,1,162235,133,t,196,63
B,1,162431,92, ,95,3
B,1,162526,97,m,144,47
B,1,162670,136,o,79,-57
B,1,162749,109,s,204,95
B,1,162953,113,t,132,19
B,1,163085,92, ,116,24
B,1,163201,180,o,76,-104
B,1,163277,83,f,104,21
B,1,163381,56, ,106,50
B,1,163487,108,t,88,-20
B,1,163575,84,h,123,39
B,1,163698,92,e,182,90
B,1,163880,88,s,170,82
B,1,164050,84,e,107,23
B,1,164157,111, ,99,-12
B,1,164256,69,w,139,70
B,1,164395,140,e,206,66
B,1,164601,86,r,171,85
B,1,164772,92,e,95,3
B,1,164867,85, ,143,58
B,1,165010,76,l,75,-1
B,1,165085,104,e,191,87
B,1,165276,104,a,170,66
B,1,165446,117,t,791,674
B,1,166237,83,a,137,54
B,1,166374,112,r,191,79
B,1,166565,88,g,162,74
B,1,166727,127,e,120,-7
B,1,166847,132,l,216,84
B,1,167063,80,y,105,25
B,1,167168,97, ,198,101
B,1,167366,117,o,4,-113
B,1,167370,80,c,282,202
B,1,167652,80,n,182,102
B,1,167834,91,c,1101,1010
B,1,168935,129,c,93,-36
B,1,169028,92,o,140,48
B,1,169168,80,n,150,70
B,1,169318,88,c,215,127
B,1,169533,109,e,163,54
B,1,169696,112,r,92,-20
B,1,169788,101,n,143,42
B,1,169931,112,e,176,64
B,1,170107,119,d,115,-4
B,1,170222,84, ,80,-4
B,1,170302,108,w,56,-52
B,1,170358,105,i,143,38
B,1,170501,109,t,36,-73
B,1,170537,52,h,116,64
B,1,170653,79, ,94,15
B,1,170747,80,t,88,8
B,1,170835,116,h,116,0
B,1,170951,104,e,100,-4
B,1,171051,105, ,88,-17
B,1,171139,105,m,137,32
B,1,171276,105,o,60,-45
B,1,171336,93,v,192,99
B,1,171528,114,e,546,432
B,1,172074,112,m,212,100
B,1,172286,128,e,100,-28
B,1,172386,112,n,116,4
B,1,172502,84,t,199,115
B,1,172701,105,s,131,26
B,1,172832,81, ,194,113
B,1,173026,144,o,84,-60
B,1,173110,96,f,114,18
B,1,173224,92, ,413,321
B,1,173637,100,s,84,-16
B,1,173721,96,m,84,-12
B,1,173805,116,a,105,-11
B,1,173910,59,l,135,76
B,1,174045,104,l,136,32
B,1,174181,108, ,253,145
B,1,174434,136,g,316,180
B,1,174750,100,r,202,102
B,1,174952,32,r,825,793
B,1,175777,85,e,160,75
B,1,175937,133,e,73,-60
B,1,176010,140,n,165,25
B,1,176175,80, ,867,787
B,1,177042,119,p,270,151
B,1,177312,133,i,187,54
B,1,177499,100,e,218,118
B,1,177717,117,c,237,120
B,1,177954,81,e,194,113
B,1,178148,77,s,214,137
B,1,178362,116, ,166,50
B,1,178528,143,o,59,-84
B,1,178587,96,f,134,38
B,1,178721,93, ,122,29
B,1,178843,91,p,121,30
B,1,178964,77,a,308,231
B,1,179272,172,p,537,365
B,1,179809,116,e,178,62
B,1,179987,144,r,99,-45
B,1,180086,146,",",191,45
B,1,180277,105, ,239,134
B,1,180516,121,w,284,163
B,1,180800,105,h,308,203
B,1,181108,112,i,149,37
B,1,181257,160,c,120,-40
B,1,181377,133,h,150,17
B,1,181527,84, ,99,15
B,1,181626,128,i,108,-20
B,1,181734,93,s,131,38
B,1,181865,96, ,139,43
B,1,182004,81,o,109,28
B,1,182113,82,d,162,80
B,1,182275,72,d,135,63
B,1,182410,97, ,132,35
B,1,182542,105,b,108,3
B,1,182650,105,e,273,168
B,1,182923,96,c,160,64
B,1,183083,100,a,136,36
B,1,183219,100,u,108,8
B,1,183327,102,s,211,109
B,1,183538,120,e,124,4
B,1,183662,100, ,970,870
B,1,184632,112,o,187,75
B,1,184819,120,n,116,-4
B,1,184935,81, ,114,33
B,1,185049,92,t,88,-4
B,1,185137,104,h,92,-12
B,1,185229,103,e,88,-15
B,1,185317,76, ,118,42
B,1,185435,84,h,0,-84
B,1,185435,48,w,166,118
B,1,185601,104,o,163,59
B,1,185764,120,l,100,-20
B,1,185864,44,r,78,34
B,1,185942,97, ,125,28
B,1,186067,104,i,2640,2536
B,1,188707,16,o,52,36
B,1,188759,127,w,96,-31
B,1,188855,93,h,920,827
B,1,189775,120,w,48,-72
B,1,189823,76,h,128,52
B,1,189951,100,o,190,90
B,1,190141,100,l,88,-12
B,1,190229,117,e,142,25
B,1,190371,97, ,132,35
B,1,190503,80,i,123,43
B,1,190626,93,t,176,83
B,1,190802,92, ,221,129
B,1,191023,131,w,163,32
B,1,191186,104,a,174,70
B,1,191360,105,s,824,719
B,1,192184,125,n,1364,1239
B,1,193548,81,',150,69
B,1,193698,60,t,291,231
B,1,193989,81, ,154,73
B,1,194143,100,t,68,-32
B,1,194211,116,h,131,15
B,1,194342,101,e,80,-21
B,1,194422,76, ,150,74
B,1,194572,84,s,60,-24
B,1,194632,81,m,114,33
B,1,194746,106,a,72,-34
B,1,194818,44,l,128,84
B,1,194946,104,l,124,20
B,1,195070,101, ,165,64
B,1,195235,108,g,202,94
B,1,195437,117,r,196,79
B,1,195633,76,e,139,63
B,1,195772,108,e,60,-48
B,1,195832,81,n,136,55
B,1,195968,88, ,91,3
B,1,196059,77,p,193,116
B,1,196252,100,i,108,8
B,1,196360,101,e,214,113
B,1,196574,104,c,266,162
B,1,196840,101,e,191,90
B,1,197031,100,s,154,54
B,1,197185,112, ,197,85
B,1,197382,92,o,76,-16
B,1,197458,97,f,135,38
B,1,197593,92, ,115,23
B,1,197708,87,p,72,-15
B,1,197780,96,a,170,74
B,1,197950,128,p,92,-36
B,1,198042,108,e,178,70
B,1,198220,108,r,116,8
B,1,198336,96, ,134,38
B,1,198470,100,t,30,-70
B,1,198500,41,',57,16
B,1,198557,89,h,161,72
B,1,198718,92,a,1480,1388
B,1,200198,96,h,138,42
B,1,200336,111,a,131,20
B,1,200467,133,t,146,13
B,1,200613,89, ,154,65
B,1,200767,89,w,163,74
B,1,200930,116,e,212,96
B,1,201142,56,r,147,91
B,1,201289,118,e,110,-8
B,1,201399,117, ,144,27
B,1,201543,69,u,159,90
B,1,201702,93,n,264,171
B,1,201966,132,a,60,-72
B,1,202026,23,h,654,631
B,1,202680,93,h,162,69
B,1,202842,111,a,80,-31
B,1,202922,60,p,139,79
B,1,203061,140,p,1074,934
B,1,204135,88,y,401,313
B,1,204536,68,.,1514,1446
B,1,206050,81, ,6940,6859
B,1,212990,108, ,NA,NA
B,2,68,92,M,225,133
B,2,293,81,y,113,32
B,2,406,100, ,152,52
B,2,558,112,f,142,30
B,2,700,108,a,184,76
B,2,884,112,v,130,18
B,2,1014,104,o,116,12
B,2,1130,144,r,112,-32
B,2,1242,76,i,110,34
B,2,1352,136,t,195,59
B,2,1547,112,e,127,15
B,2,1674,56, ,104,48
B,2,1778,108,f,84,-24
B,2,1862,80,o,144,64
B,2,2006,108,o,251,143
B,2,2257,96,d,132,36
B,2,2389,60, ,84,24
B,2,2473,89,i,69,-20
B,2,2542,108,s,109,1
B,2,2651,67, ,66,-1
B,2,2717,125,a,156,31
B,2,2873,85,n,127,42
B,2,3000,117, ,1147,1030
B,2,4147,92, ,1316,1224
B,2,5463,116,a,195,79
B,2,5658,74,c,190,116
B,2,5848,113,t,77,-36
B,2,5925,60,u,115,55
B,2,6040,140,a,72,-68
B,2,6112,76,l,159,83
B,2,6271,100,l,195,95
B,2,6466,81,y,186,105
B,2,6652,95, ,92,-3
B,2,6744,100,a,115,15
B,2,6859,100, ,190,90
B,2,7049,68,c,103,35
B,2,7152,68,o,98,30
B,2,7250,113,m,211,98
B,2,7461,40,b,91,51
B,2,7552,70,i,93,23
B,2,7645,112,n,95,-17
B,2,7740,86,a,147,61
B,2,7887,124,t,59,-65
B,2,7946,25,i,108,83
B,2,8054,86,o,79,-7
B,2,8133,108,n,158,50
B,2,8291,109, ,125,16
B,2,8416,104,o,84,-20
B,2,8500,100,f,114,14
B,2,8614,85, ,53,-32
B,2,8667,100,m,213,113
B,2,8880,72,y,123,51
B,2,9003,92, ,157,65
B,2,9160,85,t,176,91
B,2,9336,112,w,96,-16
B,2,9432,92,o,35,-57
B,2,9467,97, ,151,54
B,2,9618,112,f,123,11
B,2,9741,93,a,211,118
B,2,9952,104,v,163,59
B,2,10115,104,o,104,0
B,2,10219,116,r,138,22
B,2,10357,64,i,109,45
B,2,10466,120,t,222,102
B,2,10688,85,e,297,212
B,2,10985,72,s,269,197
B,2,11254,69,:,89,20
B,2,11343,121, ,121,0
B,2,11464,84,p,193,109
B,2,11657,92,u,116,24
B,2,11773,73,z,90,17
B,2,11863,36,z,1285,1249
B,2,13148,103,i,84,-19
B,2,13232,60,z,164,104
B,2,13396,96,z,183,87
B,2,13579,96,a,157,61
B,2,13736,38, ,90,52
B,2,13826,60,a,230,170
B,2,14056,105,n,159,54
B,2,14215,76,d,108,32
B,2,14323,76, ,105,29
B,2,14428,65,p,150,85
B,2,14578,75,o,75,0
B,2,14653,113,s,117,4
B,2,14770,81,i,150,69
B,2,14920,79,t,105,26
B,2,15025,111,i,104,-7
B,2,15129,80,v,1396,1316
B,2,16525,116,a,131,15
B,2,16656,104,s,234,130
B,2,16890,85,t,156,71
B,2,17046,108,a,60,-48
B,2,17106,104,.,210,106
B,2,17316,69, ,2209,2140
B,2,19525,105,T,108,3
B,2,19633,57,h,87,30
B,2,19720,104,e,108,4
B,2,19828,89, ,204,115
B,2,20032,108,c,241,133
B,2,20273,80,r,35,-45
B,2,20308,23,t,743,720
B,2,21051,68,e,125,57
B,2,21176,88,a,172,84
B,2,21348,108,t,144,36
B,2,21492,105,i,247,142
B,2,21739,101,o,108,7
B,2,21847,121,n,197,76
B,2,22044,98,i,8,-90
B,2,22052,69, ,233,164
B,2,22285,96,s,100,4
B,2,22385,80, ,1517,1437
B,2,23902,92, ,117,25
B,2,24019,72,i,72,0
B,2,24091,88,s,84,-4
B,2,24175,87, ,69,-18
B,2,24244,80,p,126,46
B,2,24370,132,e,68,-64
B,2,24438,56,n,128,72
B,2,24566,85,n,158,73
B,2,24724,113,e,138,25
B,2,24862,82, ,98,16
B,2,24960,108,a,93,-15
B,2,25053,36,l,130,94
B,2,25183,50,l,991,941
B,2,26174,146,l,113,-33
B,2,26287,72,a,87,15
B,2,26374,88, ,200,112
B,2,26574,92,v,99,7
B,2,26673,69,o,84,15
B,2,26757,116,d,109,-7
B,2,26866,104,k,128,24
B,2,26994,113,a,116,3
B,2,27110,97, ,136,39
B,2,27246,81,p,196,115
B,2,27442,108,i,154,46
B,2,27596,48,z,82,34
B,2,27678,61,z,246,185
B,2,27924,112,z,238,126
B,2,28162,100,a,163,63
B,2,28325,88, ,3735,3647
B,2,32060,71,",",500,429
B,2,32560,51, ,138,87
B,2,32698,100,w,76,-24
B,2,32774,56,h,91,35
B,2,32865,96,o,97,1
B,2,32962,96,s,168,72
B,2,33130,80,e,98,18
B,2,33228,73, ,132,59
B,2,33360,104,r,186,82
B,2,33546,121,e,198,77
B,2,33744,132,s,76,-56
B,2,33820,59,u,184,125
B,2,34004,100,l,76,-24
B,2,34080,76,t,121,45
B,2,34201,77, ,114,37
B,2,34315,117,i,241,124
B,2,34556,93,s,107,14
B,2,34663,69, ,211,142
B,2,34874,88,b,169,81
B,2,35043,119,o,87,-32
B,2,35130,77,t,99,22
B,2,35229,85,h,797,712
B,2,36026,97, ,189,92
B,2,36215,88,d,175,87
B,2,36390,91,e,80,-11
B,2,36470,52,l,152,100
B,2,36622,112,i,89,-23
B,2,36711,75,s,255,180
B,2,36966,87,h,635,548
B,2,37601,93, ,104,11
B,2,37705,137,i,1090,953
B,2,38795,113,a,457,344
B,2,39252,104, ,121,17
B,2,39373,108,a,97,-11
B,2,39470,60,n,106,46
B,2,39576,105,d,440,335
B,2,40016,111, ,4711,4600
B,2,44727,116,a,2537,2421
B,2,47264,42, ,72,30
B,2,47336,129,w,81,-48
B,2,47417,147,i,144,-3
B,2,47561,116,t,68,-48
B,2,47629,75,h,87,12
B,2,47716,101, ,117,16
B,2,47833,64,o,150,86
B,2,47983,141,p,170,29
B,2,48153,132,t,92,-40
B,2,48245,44,i,90,46
B,2,48335,77,o,94,17
B,2,48429,105,n,139,34
B,2,48568,105,a,53,-52
B,2,48621,112,l,100,-12
B,2,48721,76, ,180,104
B,2,48901,120,c,60,-60
B,2,48961,61,h,89,28
B,2,49050,77,i,156,79
B,2,49206,104,c,112,8
B,2,49318,109,k,147,38
B,2,49465,97,e,112,15
B,2,49577,99,n,96,-3
B,2,49673,96, ,111,15
B,2,49784,112,o,96,-16
B,2,49880,100,n,60,-40
B,2,49940,80, ,188,108
B,2,50128,97,t,334,237
B,2,50462,69,o,167,98
B,2,50629,121,p,675,554
B,2,51304,101,",",122,21
B,2,51426,57, ,81,24
B,2,51507,127,a,96,-31
B,2,51603,125,l,228,103
B,2,51831,120,t,23,-97
B,2,51854,109,h,104,-5
B,2,51958,102,o,210,108
B,2,52168,100,u,128,28
B,2,52296,108,g,64,-44
B,2,52360,92,h,134,42
B,2,52494,112, ,198,86
B,2,52692,121,i,1211,1090
B,2,53903,93,t,230,137
B,2,54133,105, ,9433,9328
B,2,63566,97,f,1201,1104
B,2,64767,87,d,96,9
B,2,64863,104,o,95,-9
B,2,64958,77,e,154,77
B,2,65112,68,s,136,68
B,2,65248,111, ,179,68
B,2,65427,111,t,162,51
B,2,65589,122,a,96,-26
B,2,65685,87,k,95,8
B,2,65780,136,e,117,-19
B,2,65897,88, ,158,70
B,2,66055,56,u,194,138
B,2,66249,48,p,51,3
B,2,66300,81, ,1004,923
B,2,67304,114,p,152,38
B,2,67456,104, ,127,23
B,2,67583,48,o,758,710
B,2,68341,117,t,226,109
B,2,68567,108,o,176,68
B,2,68743,103,o,148,45
B,2,68891,79, ,56,-23
B,2,68947,96,m,1739,1643
B,2,70686,93, ,243,150
B,2,70929,107,r,29,-78
B,2,70958,75,o,133,58
B,2,71091,96,o,143,47
B,2,71234,103,m,100,-3
B,2,71334,88, ,138,50
B,2,71472,108,f,40,-68
B,2,71512,128,o,175,47
B,2,71687,148,r,3510,3362
B,2,75197,176,m,243,67
B,2,75440,76, ,744,668
B,2,76184,76,o,99,23
B,2,76283,124,m,88,-36
B,2,76371,95, ,91,-4
B,2,76462,105,f,89,-16
B,2,76551,115,o,92,-23
B,2,76643,87,r,76,-11
B,2,76719,68, ,132,64
B,2,76851,116,p,2030,1914
B,2,78881,83, ,126,43
B,2,79007,101,t,88,-13
B,2,79095,120,h,117,-3
B,2,79212,107,e,96,-11
B,2,79308,120, ,134,14
B,2,79442,113,a,206,93
B,2,79648,96,c,226,130
B,2,79874,116,t,15,-101
B,2,79889,77,g,325,248
B,2,80214,73,u,732,659
B,2,80946,84,u,124,40
B,2,81070,91,a,87,-4
B,2,81157,101,l,101,0
B,2,81258,87, ,294,207
B,2,81552,96,a,885,789
B,2,82437,116,p,88,-28
B,2,82525,72,a,132,60
B,2,82657,116,s,228,112
B,2,82885,132,t,213,81
B,2,83098,147,a,140,-7
B,2,83238,133,.,132,-1
B,2,83370,92, ,364,272
B,2,83734,111,T,103,-8
B,2,83837,85,h,88,3
B,2,83925,112,e,109,-3
B,2,84034,92, ,220,128
B,2,84254,76,r,1,-75
B,2,84255,47,t,905,858
B,2,85160,109,e,206,97
B,2,85366,76,s,110,34
B,2,85476,77,u,206,129
B,2,85682,93,l,163,70
B,2,85845,108,t,171,63
B,2,86016,88, ,5103,5015
B,2,91119,74,p,173,99
B,2,91292,95,i,172,77
B,2,91464,125,z,183,58
B,2,91647,116,z,173,57
B,2,91820,104,a,141,37
B,2,91961,88, ,208,120
B,2,92169,105,c,214,109
B,2,92383,89,r,77,-12
B,2,92460,92,u,95,3
B,2,92555,81,s,175,94
B,2,92730,116,t,112,-4
B,2,92842,90, ,69,-21
B,2,92911,103,i,79,-24
B,2,92990,112,s,100,-12
B,2,93090,84, ,72,-12
B,2,93162,40,o,86,46
B,2,93248,116,n,163,47
B,2,93411,76, ,114,38
B,2,93525,93,t,96,3
B,2,93621,88,h,81,-7
B,2,93702,128,e,150,22
B,2,93852,62, ,112,50
B,2,93964,86,t,61,-25
B,2,94025,72,h,113,41
B,2,94138,84,i,72,-12
B,2,94210,105,c,116,11
B,2,94326,117,k,150,33
B,2,94476,88,e,147,59
B,2,94623,85,r,100,15
B,2,94723,81, ,155,74
B,2,94878,112,s,123,11
B,2,95001,117,i,65,-52
B,2,95066,76,d,144,68
B,2,95210,117,e,182,65
B,2,95392,112, ,73,-39
B,2,95465,63,b,150,87
B,2,95615,99,u,52,-47
B,2,95667,95,t,1470,1375
B,2,97137,73,",",111,38
B,2,97248,100, ,160,60
B,2,97408,28,b,92,64
B,2,97500,105,u,141,36
B,2,97641,101,t,141,40
B,2,97782,87, ,115,28
B,2,97897,92,t,80,-12
B,2,97977,69,h,98,29
B,2,98075,108,e,116,8
B,2,98191,81, ,4396,4315
B,2,102587,140,s,257,117
B,2,102844,120,t,32,-88
B,2,102876,56,i,160,104
B,2,103036,97,l,145,48
B,2,103181,133,l,264,131
B,2,103445,85, ,170,85
B,2,103615,97,c,331,234
B,2,103946,112,r,127,15
B,2,104073,53,i,217,164
B,2,104290,109,s,359,250
B,2,104649,124,p,766,642
B,2,105415,128,y,185,57
B,2,105600,57, ,5212,5155
B,2,110812,124,t,202,78
B,2,111014,101, ,20,-81
B,2,111034,100,o,761,661
B,2,111795,125,o,497,372
B,2,112292,84, ,1162,1078
B,2,113454,77,h,137,60
B,2,113591,68,o,201,133
B,2,113792,148,l,371,223
B,2,114163,97,d,350,253
B,2,114513,80, ,214,134
B,2,114727,88,t,76,-12
B,2,114803,117,h,100,-17
B,2,114903,108,e,76,-32
B,2,114979,81, ,124,43
B,2,115103,100,p,73,-27
B,2,115176,51,a,100,49
B,2,115276,105,s,212,107
B,2,115488,88,t,322,234
B,2,115810,103,a,578,475
B,2,116388,97, ,3339,3242
B,2,119727,112,p,88,-24
B,2,119815,120,a,145,25
B,2,119960,104,s,208,104
B,2,120168,92,t,153,61
B,2,120321,108,a,174,66
B,2,120495,85, ,1226,1141
B,2,121721,116,t,88,-28
B,2,121809,88,o,91,3
B,2,121900,89, ,158,69
B,2,122058,112,g,91,-21
B,2,122149,116,i,109,-7
B,2,122258,104,v,192,88
B,2,122450,103,e,75,-28
B,2,122525,100, ,100,0
B,2,122625,124,i,68,-56
B,2,122693,96,t,110,14
B,2,122803,69, ,85,16
B,2,122888,92,t,59,-33
B,2,122947,92,h,88,-4
B,2,123035,117,a,81,-36
B,2,123116,123,t,103,-20
B,2,123219,89, ,202,113
B,2,123421,120,c,229,109
B,2,123650,98,r,71,-27
B,2,123721,61,u,96,35
B,2,123817,95,n,73,-22
B,2,123890,127,c,100,-27
B,2,123990,72,h,325,253
B,2,124315,101,.,134,33
B,2,124449,88, ,194,106
B,2,124643,109,T,67,-42
B,2,124710,69,h,106,37
B,2,124816,104,e,165,61
B,2,124981,100,r,181,81
B,2,125162,141,e,205,64
B,2,125367,73, ,152,79
B,2,125519,97,a,194,97
B,2,125713,89,r,169,80
B,2,125882,121,e,292,171
B,2,126174,91, ,104,13
B,2,126278,76,a,221,145
B,2,126499,84,l,128,44
B,2,126627,129,s,128,-1
B,2,126755,139,o,124,-15
B,2,126879,68, ,128,60
B,2,127007,100,b,107,7
B,2,127114,105,a,108,3
B,2,127222,61,l,125,64
B,2,127347,108,l,116,8
B,2,127463,101,s,118,17
B,2,127581,84, ,84,0
B,2,127665,104,o,52,-52
B,2,127717,108,f,137,29
B,2,127854,108, ,56,-52
B,2,127910,112,m,189,77
B,2,128099,145,o,177,32
B,2,128276,56,z,163,107
B,2,128439,101,z,249,148
B,2,128688,104,a,188,84
B,2,128876,88,r,210,122
B,2,129086,99,e,76,-23
B,2,129162,81,l,156,75
B,2,129318,68,l,40,-28
B,2,129358,117,a,167,50
B,2,129525,60, ,75,15
B,2,129600,76,o,88,12
B,2,129688,99,n,88,-11
B,2,129776,72, ,127,55
B,2,129903,68,t,68,0
B,2,129971,115,h,112,-3
B,2,130083,117,e,1893,1776
B,2,131976,48,b,812,764
B,2,132788,80,m,88,8
B,2,132876,95,e,88,-7
B,2,132964,104,l,274,170
B,2,133238,112,t,249,137
B,2,133487,108,e,208,100
B,2,133695,97,d,138,41
B,2,133833,76, ,175,99
B,2,134008,76,i,114,38
B,2,134122,93,n,56,-37
B,2,134178,65, ,202,137
B,2,134380,40,b,52,12
B,2,134432,100,e,397,297
B,2,134829,132,t,279,147
B,2,135108,92,w,170,78
B,2,135278,97,e,171,74
B,2,135449,121,e,76,-45
B,2,135525,105,n,112,7
B,2,135637,77, ,113,36
B,2,135750,105,t,69,-36
B,2,135819,84,h,125,41
B,2,135944,136,e,117,-19
B,2,136061,104, ,39,-65
B,2,136100,121,p,253,132
B,2,136353,129,e,92,-37
B,2,136445,44,n,138,94
B,2,136583,76,n,127,51
B,2,136710,150,e,179,29
B,2,136889,76, ,129,53
B,2,137018,120,t,92,-28
B,2,137110,128,o,96,-32
B,2,137206,80, ,2931,2851
B,2,140137,108,g,137,29
B,2,140274,100,i,80,-20
B,2,140354,80,v,176,96
B,2,140530,53,r,8,-45
B,2,140538,73,e,80,7
B,2,140618,97, ,68,-29
B,2,140686,136,i,100,-36
B,2,140786,113,t,1217,1104
B,2,142003,120,e,136,16
B,2,142139,93, ,229,136
B,2,142368,132,i,121,-11
B,2,142489,92,t,114,22
B,2,142603,85, ,99,14
B,2,142702,121,t,300,179
B,2,143002,95,h,84,-11
B,2,143086,83,a,75,-8
B,2,143161,117,t,141,24
B,2,143302,83, ,48,-35
B,2,143350,100,p,229,129
B,2,143579,37,i,344,307
B,2,143923,79,e,147,68
B,2,144070,80,r,194,114
B,2,144264,60,g,440,380
B,2,144704,72,f,173,101
B,2,144877,76,e,167,91
B,2,145044,91,c,194,103
B,2,145238,116,t,123,7
B,2,145361,81, ,485,404
B,2,145846,99,c,96,-3
B,2,145942,64,h,105,41
B,2,146047,65,e,141,76
B,2,146188,84,e,206,122
B,2,146394,72,z,223,151
B,2,146617,160,e,472,312
B,2,147089,91,s,157,66
B,2,147246,80,e,97,17
B,2,147343,85, ,123,38
B,2,147466,88,p,194,106
B,2,147660,64,u,158,94
B,2,147818,84,l,149,65
B,2,147967,85,l,289,204
B,2,148256,104,.,NA,NA
C,1,159,167,F,198,31
C,1,357,200,a,135,-65
C,1,492,150,r,133,-17
C,1,625,128, ,159,31
C,1,784,165,o,97,-68
C,1,881,139,u,159,20
C,1,1040,120,t,99,-21
C,1,1139,118, ,38,-80
C,1,1177,117,i,192,75
C,1,1369,119,n,69,-50
C,1,1438,101, ,84,-17
C,1,1522,128,t,98,-30
C,1,1620,115,h,119,4
C,1,1739,130,e,157,27
C,1,1896,116, ,136,20
C,1,2032,121,u,210,89
C,1,2242,126,n,175,49
C,1,2417,61,c,241,180
C,1,2658,121,h,92,-29
C,1,2750,235,a,346,111
C,1,3096,107,r,175,68
C,1,3271,127,t,69,-58
C,1,3340,131,e,202,71
C,1,3542,131,d,68,-63
C,1,3610,110, ,190,80
C,1,3800,106,b,67,-39
C,1,3867,157,a,89,-68
C,1,3956,151,c,107,-44
C,1,4063,156,k,217,61
C,1,4280,83,s,238,155
C,1,4518,94,w,576,482
C,1,5094,188,w,69,-119
C,1,5163,218,a,128,-90
C,1,5291,120,t,157,37
C,1,5448,140,e,75,-65
C,1,5523,131,r,168,37
C,1,5691,136,s,101,-35
C,1,5792,111, ,120,9
C,1,5912,113,o,87,-26
C,1,5999,111,f,73,-38
C,1,6072,98, ,119,21
C,1,6191,101,t,79,-22
C,1,6270,91,h,90,-1
C,1,6360,144,e,97,-47
C,1,6457,139, ,105,-34
C,1,6562,89,u,205,116
C,1,6767,168,n,263,95
C,1,7030,148,f,101,-47
C,1,7131,189,a,93,-96
C,1,7224,153,s,109,-44
C,1,7333,87,h,244,157
C,1,7577,147,i,80,-67
C,1,7657,117,o,231,114
C,1,7888,85,n,98,13
C,1,7986,126,a,168,42
C,1,8154,89,b,161,72
C,1,8315,108,l,125,17
C,1,8440,104,e,83,-21
C,1,8523,101, ,129,28
C,1,8652,123,e,80,-43
C,1,8732,106,n,127,21
C,1,8859,135,d,88,-47
C,1,8947,85, ,104,19
C,1,9051,97,o,80,-17
C,1,9131,119,f,90,-29
C,1,9221,95, ,124,29
C,1,9345,95,t,58,-37
C,1,9403,96,h,110,14
C,1,9513,96,e,105,9
C,1,9618,118, ,81,-37
C,1,9699,162,w,89,-73
C,1,9788,157,e,284,127
C,1,10072,68,s,149,81
C,1,10221,91,t,185,94
C,1,10406,101,e,30,-71
C,1,10436,143,r,105,-38
C,1,10541,127,n,93,-34
C,1,10634,102, ,107,5
C,1,10741,167,s,100,-67
C,1,10841,156,p,161,5
C,1,11002,96,i,66,-30
C,1,11068,144,r,89,-55
C,1,11157,173,a,93,-80
C,1,11250,161,l,95,-66
C,1,11345,108, ,97,-11
C,1,11442,154,a,108,-46
C,1,11550,136,r,114,-22
C,1,11664,146,m,93,-53
C,1,11757,111, ,190,79
C,1,11947,67,o,80,13
C,1,12027,95,f,87,-8
C,1,12114,92, ,105,13
C,1,12219,100,t,100,0
C,1,12319,76,h,69,-7
C,1,12388,88,e,109,21
C,1,12497,119, ,633,514
C,1,13130,112,G,159,47
C,1,13289,136,a,124,-12
C,1,13413,112,l,135,23
C,1,13548,130,a,340,210
C,1,13888,155,x,135,-20
C,1,14023,151,y,114,-37
C,1,14137,114, ,1240,1126
C,1,15377,121,l,184,63
C,1,15561,128,i,84,-44
C,1,15645,125,e,57,-68
C,1,15702,122,s,98,-24
C,1,15800,112, ,96,-16
C,1,15896,117,a,96,-21
C,1,15992,110, ,180,70
C,1,16172,148,s,110,-38
C,1,16282,98,m,110,12
C,1,16392,134,a,76,-58
C,1,16468,99,l,185,86
C,1,16653,139,l,67,-72
C,1,16720,114, ,152,38
C,1,16872,85,u,188,103
C,1,17060,138,n,83,-55
C,1,17143,119,r,59,-60
C,1,17202,144,e,140,-4
C,1,17342,118,g,101,-17
C,1,17443,206,a,115,-91
C,1,17558,104,r,241,137
C,1,17799,118,d,244,126
C,1,18043,101,e,195,94
C,1,18238,106,d,176,70
C,1,18414,105, ,811,706
C,1,19225,109,y,122,13
C,1,19347,167,e,146,-21
C,1,19493,71,l,157,86
C,1,19650,66,l,157,91
C,1,19807,78,o,82,4
C,1,19889,126,w,91,-35
C,1,19980,88, ,122,34
C,1,20102,126,s,68,-58
C,1,20170,109,u,242,133
C,1,20412,51,n,642,591
C,1,21054,118,.,1308,1190
C,1,22362,101,O,92,-9
C,1,22454,126,r,130,4
C,1,22584,93,b,188,95
C,1,22772,85,i,120,35
C,1,22892,68,t,324,256
C,1,23216,101,i,238,137
C,1,23454,118,g,139,21
C,1,23593,77,n,608,531
C,1,24201,116,n,87,-29
C,1,24288,116,g,96,-20
C,1,24384,103, ,140,37
C,1,24524,122,t,67,-55
C,1,24591,169,h,173,4
C,1,24764,92,i,127,35
C,1,24891,101,s,114,13
C,1,25005,112, ,72,-40
C,1,25077,168,a,153,-15
C,1,25230,124,t,115,-9
C,1,25345,99, ,63,-36
C,1,25408,150,a,121,-29
C,1,25529,116, ,317,201
C,1,25846,127,d,194,67
C,1,26040,139,i,63,-76
C,1,26103,148,s,115,-33
C,1,26218,127,t,98,-29
C,1,26316,168,a,194,26
C,1,26510,108,n,102,-6
C,1,26612,134,c,92,-42
C,1,26704,150,e,102,-48
C,1,26806,90, ,98,8
C,1,26904,95,o,166,71
C,1,27070,96, ,533,437
C,1,27603,125,f,130,5
C,1,27733,114, ,122,8
C,1,27855,115,r,90,-25
C,1,27945,158,o,89,-69
C,1,28034,111,u,86,-25
C,1,28120,111,g,122,11
C,1,28242,92,h,242,150
C,1,28484,120,l,135,15
C,1,28619,130,y,170,40
C,1,28789,115, ,369,254
C,1,29158,118, ,424,306
C,1,29582,106,n,110,4
C,1,29692,108,i,136,28
C,1,29828,106,g,114,8
C,1,29942,76,n,546,470
C,1,30488,142,n,318,176
C,1,30806,126,t,232,106
C,1,31038,117,e,192,75
C,1,31230,110,y,1694,1584
C,1,32924,119,n,648,529
C,1,33572,136,e,280,144
C,1,33852,142,t,117,-25
C,1,33969,103,y,471,368
C,1,34440,154,t,134,-20
C,1,34574,154,w,140,-14
C,1,34714,147,o,286,139
C,1,35000,117, ,251,134
C,1,35251,98,m,157,59
C,1,35408,91,i,214,123
C,1,35622,88,l,154,66
C,1,35776,96,l,170,74
C,1,35946,136,i,80,-56
C,1,36026,124,o,168,44
C,1,36194,137,n,91,-46
C,1,36285,129, ,158,29
C,1,36443,102,m,177,75
C,1,36620,87,i,219,132
C,1,36839,114,l,135,21
C,1,36974,162,e,78,-84
C,1,37052,178,s,131,-47
C,1,37183,130, ,162,32
C,1,37345,111,i,124,13
C,1,37469,113,n,449,336
C,1,37918,125,s,79,-46
C,1,37997,114, ,127,13
C,1,38124,136,a,73,-63
C,1,38197,164,n,119,-45
C,1,38316,108, ,188,80
C,1,38504,114,u,146,32
C,1,38650,78,t,162,84
C,1,38812,114,t,101,-13
C,1,38913,214,e,139,-75
C,1,39052,85,r,68,-17
C,1,39120,113,l,137,24
C,1,39257,142,y,110,-32
C,1,39367,138, ,132,-6
C,1,39499,109,i,211,102
C,1,39710,126,n,441,315
C,1,40151,143,s,131,-12
C,1,40282,106,i,110,4
C,1,40392,134,g,133,-1
C,1,40525,124,n,124,0
C,1,40649,120,i,415,295
C,1,41064,118,f,114,-4
C,1,41178,129,i,104,-25
C,1,41282,144,c,118,-26
C,1,41400,179,a,111,-68
C,1,41511,106,n,219,113
C,1,41730,105, ,185,80
C,1,41915,101,l,170,69
C,1,42085,101,i,25,-76
C,1,42110,110,t,203,93
C,1,42313,117,t,93,-24
C,1,42406,130,l,109,-21
C,1,42515,141,e,91,-50
C,1,42606,133, ,208,75
C,1,42814,143,v,110,-33
C,1,42924,99,l,184,85
C,1,43108,100,u,113,13
C,1,43221,133,e,93,-40
C,1,43314,136, ,1840,1704
C,1,45154,135,b,105,-30
C,1,45259,90,l,181,91
C,1,45440,93,u,157,64
C,1,45597,88,e,157,69
C,1,45754,138, ,231,93
C,1,45985,104,f,197,93
C,1,46182,157,r,101,-56
C,1,46283,111,e,197,86
C,1,46480,136,e,50,-86
C,1,46530,124,n,108,-16
C,1,46638,106, ,752,646
C,1,47390,146, ,174,28
C,1,47564,177,p,100,-77
C,1,47664,119,l,138,19
C,1,47802,142,a,157,15
C,1,47959,135,n,351,216
C,1,48310,136,e,145,9
C,1,48455,129,t,213,84
C,1,48668,120, ,602,482
C,1,49270,132,w,85,-47
C,1,49355,169,h,96,-73
C,1,49451,140,o,216,76
C,1,49667,155,s,134,-21
C,1,49801,156,e,160,4
C,1,49961,107, ,188,81
C,1,50149,141,a,121,-20
C,1,50270,100,p,110,10
C,1,50380,119,e,534,415
C,1,50914,67,d,177,110
C,1,51091,128,e,121,-7
C,1,51212,181,s,204,23
C,1,51416,142,c,190,48
C,1,51606,133,e,177,44
C,1,51783,137,n,136,-1
C,1,51919,109,d,202,93
C,1,52121,87,e,185,98
C,1,52306,140,d,30,-110
C,1,52336,128, ,169,41
C,1,52505,97,l,166,69
C,1,52671,111,i,81,-30
C,1,52752,140,f,64,-76
C,1,52816,162,e,118,-44
C,1,52934,111, ,102,-9
C,1,53036,117,f,110,-7
C,1,53146,80,o,93,13
C,1,53239,113,r,117,4
C,1,53356,117,m,95,-22
C,1,53451,147,s,188,41
C,1,53639,143,a,188,45
C,1,53827,114, ,114,0
C,1,53941,105,r,616,511
C,1,54557,190,a,126,-64
C,1,54683,159,r,72,-87
C,1,54755,150,e,165,15
C,1,54920,117, ,186,69
C,1,55106,166,s,84,-82
C,1,55190,153,o,68,-85
C,1,55258,128, ,150,22
C,1,55408,164,a,150,-14
C,1,55558,93,m,154,61
C,1,55712,107,a,268,161
C,1,55980,167,z,115,-52
C,1,56095,141,i,106,-35
C,1,56201,123,n,327,204
C,1,56528,93,g,135,42
C,1,56663,88,l,101,13
C,1,56764,118,y,151,33
C,1,56915,122, ,256,134
C,1,57171,125,p,261,136
C,1,57432,159,r,98,-61
C,1,57530,81,i,187,106
C,1,57717,172,m,135,-37
C,1,57852,101,i,128,27
C,1,57980,86,t,61,-25
C,1,58041,130,i,198,68
C,1,58239,164,v,126,-38
C,1,58365,148,e,112,-36
C,1,58477,97, ,110,13
C,1,58587,123,t,110,-13
C,1,58697,106,h,29,-77
C,1,58726,182,a,97,-85
C,1,58823,171,t,151,-20
C,1,58974,114, ,474,360
C,1,59448,114,t,92,-22
C,1,59540,92,h,164,72
C,1,59704,160,e,101,-59
C,1,59805,153,y,115,-38
C,1,59920,97, ,210,113
C,1,60130,128,s,128,0
C,1,60258,152,t,73,-79
C,1,60331,83,i,179,96
C,1,60510,101,l,169,68
C,1,60679,145,l,59,-86
C,1,60738,128, ,116,-12
C,1,60854,142,t,96,-46
C,1,60950,109,h,67,-42
C,1,61017,148,i,152,4
C,1,61169,119,n,191,72
C,1,61360,168,k,108,-60
C,1,61468,124, ,468,344
C,1,61936,112,d,126,14
C,1,62062,124,i,207,83
C,1,62269,132,s,612,480
C,1,62881,134,g,74,-60
C,1,62955,148,i,307,159
C,1,63262,122,t,182,60
C,1,63444,152,a,196,44
C,1,63640,165,l,98,-67
C,1,63738,130, ,88,-42
C,1,63826,174,w,128,-46
C,1,63954,188,a,281,93
C,1,64235,135,t,155,20
C,1,64390,59,e,625,566
C,1,65015,75,c,150,75
C,1,65165,102,h,124,22
C,1,65289,152,e,141,-11
C,1,65430,143,s,148,5
C,1,65578,120, ,132,12
C,1,65710,194,a,174,-20
C,1,65884,151,r,63,-88
C,1,65947,174,e,216,42
C,1,66163,96, ,92,-4
C,1,66255,143,a,89,-54
C,1,66344,126, ,118,-8
C,1,66462,112,p,72,-40
C,1,66534,144,r,53,-91
C,1,66587,166,e,187,21
C,1,66774,75,t,158,83
C,1,66932,148,t,79,-69
C,1,67011,154,y,121,-33
C,1,67132,126, ,242,116
C,1,67374,126,n,59,-67
C,1,67433,149,e,81,-68
C,1,67514,162,a,62,-100
C,1,67576,143,t,166,23
C,1,67742,80, ,145,65
C,1,67887,113, ,169,56
C,1,68056,141,i,64,-77
C,1,68120,110,d,235,125
C,1,68355,155,e,331,176
C,1,68686,140,a,363,223
C,1,69049,134,d,783,649
C,1,69832,72,s,668,596
C,1,70500,110,.,1377,1267
C,1,71877,99,T,126,27
C,1,72003,70,h,83,13
C,1,72086,183,e,150,-33
C,1,72236,123, ,292,169
C,1,72528,168,p,84,-84
C,1,72612,121,l,83,-38
C,1,72695,151,a,122,-29
C,1,72817,92,n,175,83
C,1,72992,143,e,252,109
C,1,73244,111,t,144,33
C,1,73388,104, ,412,308
C,1,73800,101,h,80,-21
C,1,73880,138,a,147,9
C,1,74027,139,s,100,-39
C,1,74127,149,",",110,-39
C,1,74237,110, ,451,341
C,1,74688,100,o,94,-6
C,1,74782,123,r,136,13
C,1,74918,122, ,632,510
C,1,75550,160,r,150,-10
C,1,75700,176,a,271,95
C,1,75971,89,h,154,65
C,1,76125,170,e,147,-23
C,1,76272,165,r,1279,1114
C,1,77551,123,t,123,0
C,1,77674,114,h,59,-55
C,1,77733,183,e,72,-111
C,1,77805,166,r,153,-13
C,1,77958,127, ,223,96
C,1,78181,131,h,125,-6
C,1,78306,143,a,93,-50
C,1,78399,144,d,123,-21
C,1,78522,160,",",169,9
C,1,78691,83, ,918,835
C,1,79609,110, ,105,-5
C,1,79714,145,a,159,14
C,1,79873,87,p,138,51
C,1,80011,81,r,72,-9
C,1,80083,129,o,700,571
C,1,80783,122, ,622,500
C,1,81405,109, ,178,69
C,1,81583,109,p,79,-30
C,1,81662,110,r,136,26
C,1,81798,110,o,97,-13
C,1,81895,139,b,153,14
C,1,82048,117,l,164,47
C,1,82212,132,e,90,-42
C,1,82302,128,m,272,144
C,1,82574,118,",",151,33
C,1,82725,130, ,260,130
C,1,82985,130,w,50,-80
C,1,83035,153,h,102,-51
C,1,83137,94,i,135,41
C,1,83272,147,c,101,-46
C,1,83373,129,h,100,-29
C,1,83473,126, ,975,849
C,1,84448,144,w,107,-37
C,1,84555,198,a,140,-58
C,1,84695,153,s,152,-1
C,1,84847,101, ,80,-21
C,1,84927,125,t,96,-29
C,1,85023,160,h,93,-67
C,1,85116,135,i,116,-19
C,1,85232,107,s,419,312
C,1,85651,133,:,689,556
C,1,86340,96, ,178,82
C,1,86518,189,m,118,-71
C,1,86636,128,o,58,-70
C,1,86694,162,s,137,-25
C,1,86831,88,t,92,4
C,1,86923,81, ,143,62
C,1,87066,113,o,117,4
C,1,87183,107,f,85,-22
C,1,87268,102, ,124,22
C,1,87392,113,t,72,-41
C,1,87464,87,h,111,24
C,1,87575,155,e,57,-98
C,1,87632,144, ,135,-9
C,1,87767,110,p,119,9
C,1,87886,140,e,33,-107
C,1,87919,136,o,111,-25
C,1,88030,202,p,139,-63
C,1,88169,97,l,101,4
C,1,88270,137,e,150,13
C,1,88420,112, ,142,30
C,1,88562,123,o,180,57
C,1,88742,142,n,71,-71
C,1,88813,139, ,196,57
C,1,89009,128,i,129,1
C,1,89138,106,t,99,-7
C,1,89237,115, ,108,-7
C,1,89345,178,w,93,-85
C,1,89438,125,e,213,88
C,1,89651,161,r,98,-63
C,1,89749,154,e,665,511
C,1,90414,105, ,568,463
C,1,90982,112,n,184,72
C,1,91166,92,h,704,612
C,1,91870,100,u,182,82
C,1,92052,96,n,174,78
C,1,92226,94,h,122,28
C,1,92348,183,a,98,-85
C,1,92446,94,p,179,85
C,1,92625,71,p,846,775
C,1,93471,114,y,115,1
C,1,93586,133, ,146,13
C,1,93732,125,f,125,0
C,1,93857,103,o,98,-5
C,1,93955,128,r,92,-36
C,1,94047,128, ,178,50
C,1,94225,117,p,88,-29
C,1,94313,147,r,76,-71
C,1,94389,151,e,202,51
C,1,94591,42,t,159,117
C,1,94750,121,t,79,-42
C,1,94829,128,y,77,-51
C,1,94906,112, ,201,89
C,1,95107,136,m,215,79
C,1,95322,92,i,127,35
C,1,95449,130,c,76,-54
C,1,95525,149,h,110,-39
C,1,95635,138, ,793,655
C,1,96428,109,o,132,23
C,1,96560,96,f,88,-8
C,1,96648,108, ,108,0
C,1,96756,128,t,99,-29
C,1,96855,84,h,106,22
C,1,96961,113,e,92,-21
C,1,97053,115, ,164,49
C,1,97217,152,t,63,-89
C,1,97280,93,i,192,99
C,1,97472,118,m,146,28
C,1,97618,122,e,382,260
C,1,98000,107,.,184,77
C,1,98184,112, ,208,96
C,1,98392,117,M,171,54
C,1,98563,133,a,51,-82
C,1,98614,94,n,216,122
C,1,98830,162,y,126,-36
C,1,98956,107, ,350,243
C,1,99306,140,s,63,-77
C,1,99369,87,o,163,76
C,1,99532,97,l,109,12
C,1,99641,155,t,280,125
C,1,99921,68,i,1290,1222
C,1,101211,110,u,132,22
C,1,101343,129,t,121,-8
C,1,101464,142,i,76,-66
C,1,101540,96,o,155,59
C,1,101695,104,n,118,14
C,1,101813,97,s,84,-13
C,1,101897,127, ,139,12
C,1,102036,182,w,110,-72
C,1,102146,144,e,228,84
C,1,102374,163,r,67,-96
C,1,102441,138,e,121,-17
C,1,102562,117, ,95,-22
C,1,102657,135,s,106,-29
C,1,102763,93,u,191,98
C,1,102954,62,g,120,58
C,1,103074,118,g,37,-81
C,1,103111,210,e,68,-142
C,1,103179,175,s,129,-46
C,1,103308,175,t,123,-52
C,1,103431,119,e,215,96
C,1,103646,120,d,74,-46
C,1,103720,101, ,145,44
C,1,103865,121,f,125,4
C,1,103990,111,o,82,-29
C,1,104072,133,r,106,-27
C,1,104178,112, ,102,-10
C,1,104280,142,t,113,-29
C,1,104393,138,h,77,-61
C,1,104470,124,i,90,-34
C,1,104560,168,s,110,-58
C,1,104670,129, ,240,111
C,1,104910,104,p,90,-14
C,1,105000,108,r,108,0
C,1,105108,104,o,184,80
C,1,105292,163,b,186,23
C,1,105478,96,l,108,12
C,1,105586,158,e,128,-30
C,1,105714,101,m,184,83
C,1,105898,176,",",134,-42
C,1,106032,119, ,302,183
C,1,106334,186,b,127,-59
C,1,106461,103,u,103,0
C,1,106564,118,t,102,-16
C,1,106666,96, ,100,4
C,1,106766,117,t,101,-16
C,1,106867,78,h,598,520
C,1,107465,174,m,98,-76
C,1,107563,153,o,129,-24
C,1,107692,175,s,120,-55
C,1,107812,107,t,94,-13
C,1,107906,94, ,140,46
C,1,108046,131,o,105,-26
C,1,108151,117,f,110,-7
C,1,108261,112, ,133,21
C,1,108394,122,t,109,-13
C,1,108503,150,h,55,-95
C,1,108558,133,e,138,5
C,1,108696,184,s,133,-51
C,1,108829,143,e,147,4
C,1,108976,115, ,38,-77
C,1,109014,183,w,103,-80
C,1,109117,149,e,207,58
C,1,109324,155,r,96,-59
C,1,109420,146,e,51,-95
C,1,109471,151, ,169,18
C,1,109640,148,l,72,-76
C,1,109712,156,a,85,-71
C,1,109797,122,r,218,96
C,1,110015,114,g,81,-33
C,1,110096,156,e,171,15
C,1,110267,91,l,33,-58
C,1,110300,134,y,150,16
C,1,110450,128, ,191,63
C,1,110641,148,c,80,-68
C,1,110721,109,o,162,53
C,1,110883,131,n,10,-121
C,1,110893,142,c,158,16
C,1,111051,142,e,130,-12
C,1,111181,113,r,178,65
C,1,111359,152,n,110,-42
C,1,111469,115,e,243,128
C,1,111712,140,d,214,74
C,1,111926,128, ,834,706
C,1,112760,147,w,80,-67
C,1,112840,82,i,126,44
C,1,112966,132,t,51,-81
C,1,113017,162,h,94,-68
C,1,113111,135, ,173,38
C,1,113284,101,t,63,-38
C,1,113347,84,h,107,23
C,1,113454,127,e,71,-56
C,1,113525,102, ,192,90
C,1,113717,136,m,69,-67
C,1,113786,137,o,284,147
C,1,114070,168,v,147,-21
C,1,114217,127,e,142,15
C,1,114359,85,m,89,4
C,1,114448,118,e,96,-22
C,1,114544,120,n,189,69
C,1,114733,132,s,491,359
C,1,115224,131,t,136,5
C,1,115360,147,s,136,-11
C,1,115496,107, ,129,22
C,1,115625,106,o,81,-25
C,1,115706,108,f,109,1
C,1,115815,115, ,228,113
C,1,116043,93,s,81,-12
C,1,116124,115,m,95,-20
C,1,116219,151,a,111,-40
C,1,116330,74,l,157,83
C,1,116487,139,l,76,-63
C,1,116563,128, ,81,-47
C,1,116644,114,f,222,108
C,1,116866,166,r,86,-80
C,1,116952,123,e,202,79
C,1,117154,174,e,93,-81
C,1,117247,124,n,90,-34
C,1,117337,111, ,169,58
C,1,117506,181,p,146,-35
C,1,117652,146,i,73,-73
C,1,117725,187,e,117,-70
C,1,117842,230,c,196,-34
C,1,118038,159,e,126,-33
C,1,118164,151,s,121,-30
C,1,118285,118, ,131,13
C,1,118416,94,o,87,-7
C,1,118503,125,f,98,-27
C,1,118601,116, ,123,7
C,1,118724,98,p,54,-44
C,1,118778,149,a,148,-1
C,1,118926,94,p,84,-10
C,1,119010,188,e,96,-92
C,1,119106,161,r,123,-38
C,1,119229,137,",",140,3
C,1,119369,88, ,133,45
C,1,119502,139,w,93,-46
C,1,119595,113,h,75,-38
C,1,119670,109,i,128,19
C,1,119798,160,c,65,-95
C,1,119863,109,h,94,-15
C,1,119957,112, ,128,16
C,1,120085,123,i,115,-8
C,1,120200,143,s,58,-85
C,1,120258,115, ,154,39
C,1,120412,143,o,131,-12
C,1,120543,110,f,202,92
C,1,120745,135,f,92,-43
C,1,120837,103, ,250,147
C,1,121087,94,b,94,0
C,1,121181,130,e,1415,1285
C,1,122596,84,d,168,84
C,1,122764,138,d,83,-55
C,1,122847,120, ,224,104
C,1,123071,122,b,89,-33
C,1,123160,154,e,147,-7
C,1,123307,169,c,131,-38
C,1,123438,144,a,148,4
C,1,123586,92,u,124,32
C,1,123710,193,s,68,-125
C,1,123778,172,e,119,-53
C,1,123897,135, ,543,408
C,1,124440,97,o,167,70
C,1,124607,138,n,67,-71
C,1,124674,123, ,114,-9
C,1,124788,138,t,81,-57
C,1,124869,99,h,125,26
C,1,124994,124,e,132,8
C,1,125126,109, ,186,77
C,1,125312,140,w,59,-81
C,1,125371,157,h,111,-46
C,1,125482,107,o,197,90
C,1,125679,105,l,123,18
C,1,125802,94,e,55,-39
C,1,125857,115, ,261,146
C,1,126118,110,t,785,675
C,1,126903,149,i,142,-7
C,1,127045,149,t,120,-29
C,1,127165,125, ,109,-16
C,1,127274,110,w,222,112
C,1,127496,161,a,119,-42
C,1,127615,134,s,119,-15
C,1,127734,82,n,193,111
C,1,127927,144,',148,4
C,1,128075,72,t,102,30
C,1,128177,101, ,104,3
C,1,128281,92,t,109,17
C,1,128390,91,h,83,-8
C,1,128473,135,e,98,-37
C,1,128571,111, ,662,551
C,1,129233,134,s,76,-58
C,1,129309,101,m,129,28
C,1,129438,106,a,85,-21
C,1,129523,64,l,145,81
C,1,129668,142,l,54,-88
C,1,129722,130, ,408,278
C,1,130130,107,g,78,-29
C,1,130208,157,r,118,-39
C,1,130326,127,e,211,84
C,1,130537,162,e,92,-70
C,1,130629,90,n,100,10
C,1,130729,118, ,141,23
C,1,130870,189,p,142,-47
C,1,131012,135,i,68,-67
C,1,131080,139,e,54,-85
C,1,131134,237,c,208,-29
C,1,131342,160,e,73,-87
C,1,131415,155,s,112,-43
C,1,131527,89, ,135,46
C,1,131662,71,o,80,9
C,1,131742,109,f,66,-43
C,1,131808,120, ,248,128
C,1,132056,105,p,97,-8
C,1,132153,128,a,111,-17
C,1,132264,152,p,136,-16
C,1,132400,188,e,130,-58
C,1,132530,118,r,119,1
C,1,132649,106, ,106,0
C,1,132755,99,t,83,-16
C,1,132838,106,h,63,-43
C,1,132901,162,a,82,-80
C,1,132983,139,t,109,-30
C,1,133092,131, ,107,-24
C,1,133199,180,w,84,-96
C,1,133283,162,e,300,138
C,1,133583,155,r,71,-84
C,1,133654,175,e,132,-43
C,1,133786,110, ,243,133
C,1,134029,92,u,177,85
C,1,134206,77,n,144,67
C,1,134350,123,h,108,-15
C,1,134458,167,a,87,-80
C,1,134545,93,p,142,49
C,1,134687,113,p,122,9
C,1,134809,130,y,157,27
C,1,134966,104,.,NA,NA
C,2,354,115,O,178,63
C,2,532,111,n,125,14
C,2,657,161,e,85,-76
C,2,742,101, ,114,13
C,2,856,135,o,127,-8
C,2,983,145,f,98,-47
C,2,1081,106, ,142,36
C,2,1223,74,m,174,100
C,2,1397,150,y,93,-57
C,2,1490,107, ,273,166
C,2,1763,159,f,125,-34
C,2,1888,139,a,136,-3
C,2,2024,101,v,77,-24
C,2,2101,141,o,142,1
C,2,2243,120,r,110,-10
C,2,2353,139,i,89,-50
C,2,2442,136,t,59,-77
C,2,2501,137,e,141,4
C,2,2642,123, ,555,432
C,2,3197,122,f,93,-29
C,2,3290,88,o,171,83
C,2,3461,85,o,55,-30
C,2,3516,162,d,124,-38
C,2,3640,171,s,156,-15
C,2,3796,128, ,325,197
C,2,4121,127,t,89,-38
C,2,4210,162,o,99,-63
C,2,4309,131, ,168,37
C,2,4477,165,e,81,-84
C,2,4558,244,a,128,-116
C,2,4686,160,t,142,-18
C,2,4828,135, ,144,9
C,2,4972,160,i,139,-21
C,2,5111,94,n,465,371
C,2,5576,153,s,130,-23
C,2,5706,144, ,1283,1139
C,2,6989,182,a,97,-85
C,2,7086,113, ,168,55
C,2,7254,102,b,205,103
C,2,7459,75,o,88,13
C,2,7547,165,w,131,-34
C,2,7678,148,l,100,-48
C,2,7778,120, ,166,46
C,2,7944,110,o,113,3
C,2,8057,86,f,86,0
C,2,8143,124, ,343,219
C,2,8486,126,m,205,79
C,2,8691,83,u,183,100
C,2,8874,125,l,159,34
C,2,9033,80,t,56,-24
C,2,9089,78,i,593,515
C,2,9682,101,g,89,-12
C,2,9771,160,r,113,-47
C,2,9884,170,i,9,-161
C,2,9893,153,a,80,-73
C,2,9973,183,n,99,-84
C,2,10072,136, ,1083,947
C,2,11155,175,a,81,-94
C,2,11236,94,i,190,96
C,2,11426,127,n,77,-50
C,2,11503,99, ,118,19
C,2,11621,123,c,107,-16
C,2,11728,142,h,117,-25
C,2,11845,137,e,227,90
C,2,12072,146,e,185,39
C,2,12257,131,r,144,13
C,2,12401,178,i,113,-65
C,2,12514,144,o,116,-28
C,2,12630,160,s,149,-11
C,2,12779,123, ,157,34
C,2,12936,202,a,185,-17
C,2,13121,104,t,103,-1
C,2,13224,119, ,104,-15
C,2,13328,160,a,233,73
C,2,13561,99,b,169,70
C,2,13730,122,o,76,-46
C,2,13806,89,u,69,-20
C,2,13875,102,t,110,8
C,2,13985,110, ,642,532
C,2,14627,98,p,186,88
C,2,14813,150,m,144,-6
C,2,14957,112, ,1028,916
C,2,15985,105, ,953,848
C,2,16938,130, ,177,47
C,2,17115,96,p,190,94
C,2,17305,117,.,276,159
C,2,17581,134,m,184,50
C,2,17765,138,.,207,69
C,2,17972,121, ,121,0
C,2,18093,181,a,269,88
C,2,18362,97,t,89,-8
C,2,18451,98, ,169,71
C,2,18620,89,n,63,-26
C,2,18683,112,i,103,-9
C,2,18786,100,g,93,-7
C,2,18879,77,h,91,14
C,2,18970,127,t,117,-10
C,2,19087,98,.,194,96
C,2,19281,109, ,261,152
C,2,19542,124,T,147,23
C,2,19689,122,h,146,24
C,2,19835,147,e,130,-17
C,2,19965,183,r,108,-75
C,2,20073,153,e,249,96
C,2,20322,103, ,119,16
C,2,20441,105,i,158,53
C,2,20599,115,s,68,-47
C,2,20667,95, ,132,37
C,2,20799,137,s,82,-55
C,2,20881,92,o,125,33
C,2,21006,122,m,88,-34
C,2,21094,182,e,120,-62
C,2,21214,134,t,62,-72
C,2,21276,80,h,59,-21
C,2,21335,139,i,105,-34
C,2,21440,97,n,80,-17
C,2,21520,102,g,102,0
C,2,21622,107, ,107,0
C,2,21729,105,s,83,-22
C,2,21812,118,o,68,-50
C,2,21880,123, ,211,88
C,2,22091,94,f,610,516
C,2,22701,161,r,70,-91
C,2,22771,132,e,421,289
C,2,23192,97,f,191,94
C,2,23383,116,r,46,-70
C,2,23429,141,e,128,-13
C,2,23557,178,s,106,-72
C,2,23663,111,h,72,-39
C,2,23735,132,i,110,-22
C,2,23845,112,n,77,-35
C,2,23922,120,g,95,-25
C,2,24017,106, ,63,-43
C,2,24080,184,a,99,-85
C,2,24179,94,b,160,66
C,2,24339,128,o,67,-61
C,2,24406,70,u,78,8
C,2,24484,114,t,80,-34
C,2,24564,131, ,135,4
C,2,24699,97,t,71,-26
C,2,24770,165,a,84,-81
C,2,24854,81,k,145,64
C,2,24999,81,i,155,74
C,2,25154,109,n,80,-29
C,2,25234,113,g,95,-18
C,2,25329,103, ,112,9
C,2,25441,147,a,67,-80
C,2,25508,93, ,152,59
C,2,25660,136,h,101,-35
C,2,25761,86,o,35,-51
C,2,25796,131,t,131,0
C,2,25927,112, ,135,23
C,2,26062,126,s,150,24
C,2,26212,144,h,177,33
C,2,26389,113,o,84,-29
C,2,26473,177,w,117,-60
C,2,26590,106,e,194,88
C,2,26784,143,r,247,104
C,2,27031,121,",",161,40
C,2,27192,165, ,800,635
C,2,27992,143,w,88,-55
C,2,28080,177,a,88,-89
C,2,28168,98,l,183,85
C,2,28351,79,k,148,69
C,2,28499,80,i,156,76
C,2,28655,93,n,63,-30
C,2,28718,127,g,132,5
C,2,28850,104, ,385,281
C,2,29235,110,i,184,74
C,2,29419,96,n,112,16
C,2,29531,101,t,92,-9
C,2,29623,170,o,94,-76
C,2,29717,110, ,88,-22
C,2,29805,110,t,76,-34
C,2,29881,102,h,106,4
C,2,29987,106,e,73,-33
C,2,30060,106, ,136,30
C,2,30196,88,k,162,74
C,2,30358,108,i,32,-76
C,2,30390,80,t,222,142
C,2,30612,149,c,110,-39
C,2,30722,68,h,107,39
C,2,30829,143,e,151,8
C,2,30980,84,n,212,128
C,2,31192,104,",",152,48
C,2,31344,127, ,145,18
C,2,31489,147,a,62,-85
C,2,31551,170,s,600,430
C,2,32151,102,n,68,-34
C,2,32219,124,d,114,-10
C,2,32333,108, ,103,-5
C,2,32436,107,d,90,-17
C,2,32526,80,o,101,21
C,2,32627,152,w,135,-17
C,2,32762,123,n,264,141
C,2,33026,168,i,105,-63
C,2,33131,113,n,105,-8
C,2,33236,105,g,93,-12
C,2,33329,100, ,136,36
C,2,33465,132,a,86,-46
C,2,33551,118, ,412,294
C,2,33963,177,c,410,233
C,2,34373,86,o,148,62
C,2,34521,89,o,205,116
C,2,34726,100,l,241,141
C,2,34967,126,",",164,38
C,2,35131,122, ,2035,1913
C,2,37166,117,l,196,79
C,2,37362,93,i,101,8
C,2,37463,126,g,84,-42
C,2,37547,88,h,114,26
C,2,37661,130,t,134,4
C,2,37795,101, ,575,474
C,2,38370,76,b,95,19
C,2,38465,126,o,145,19
C,2,38610,148,w,79,-69
C,2,38689,154,l,111,-43
C,2,38800,120, ,153,33
C,2,38953,104,o,96,-8
C,2,39049,120,f,90,-30
C,2,39139,116, ,971,855
C,2,40110,118,m,202,84
C,2,40312,85,u,157,72
C,2,40469,97,t,64,-33
C,2,40533,72,l,152,80
C,2,40685,91,i,874,783
C,2,41559,77,g,70,-7
C,2,41629,160,r,139,-21
C,2,41768,186,a,156,-30
C,2,41924,229,i,139,-90
C,2,42063,128,n,416,288
C,2,42479,138, ,349,211
C,2,42828,119,c,13,-106
C,2,42841,136,h,265,129
C,2,43106,123,e,236,113
C,2,43342,109,e,175,66
C,2,43517,111,r,72,-39
C,2,43589,178,i,125,-53
C,2,43714,108,o,139,31
C,2,43853,102,r,455,353
C,2,44308,119,s,102,-17
C,2,44410,139, ,895,756
C,2,45305,126,o,110,-16
C,2,45415,93,r,94,1
C,2,45509,112, ,121,9
C,2,45630,112,t,79,-33
C,2,45709,124,w,99,-25
C,2,45808,95,o,501,406
C,2,46309,126,.,226,100
C,2,46535,109, ,325,216
C,2,46860,79,Y,133,54
C,2,46993,242,o,123,-119
C,2,47116,123,u,46,-77
C,2,47162,156, ,620,464
C,2,47782,168,f,125,-43
C,2,47907,94,e,210,116
C,2,48117,91,e,109,18
C,2,48226,152,l,127,-25
C,2,48353,135, ,403,268
C,2,48756,116,g,94,-22
C,2,48850,72,o,133,61
C,2,48983,90,o,59,-31
C,2,49042,154,d,112,-42
C,2,49154,122, ,92,-30
C,2,49246,114,a,106,-8
C,2,49352,75,b,110,35
C,2,49462,147,o,84,-63
C,2,49546,105,u,84,-21
C,2,49630,115,t,93,-22
C,2,49723,133, ,90,-43
C,2,49813,183,e,111,-72
C,2,49924,170,a,125,-45
C,2,50049,141,t,103,-38
C,2,50152,85,i,150,65
C,2,50302,114,n,97,-17
C,2,50399,119,g,77,-42
C,2,50476,89, ,97,8
C,2,50573,154,a,69,-85
C,2,50642,94, ,178,84
C,2,50820,123,n,68,-55
C,2,50888,193,o,177,-16
C,2,51065,136,n,820,684
C,2,51885,139,s,113,-26
C,2,51998,110,u,172,62
C,2,52170,134,g,111,-23
C,2,52281,145,a,69,-76
C,2,52350,187,r,123,-64
C,2,52473,187,y,123,-64
C,2,52596,128, ,711,583
C,2,53307,167,c,175,8
C,2,53482,148,e,113,-35
C,2,53595,195,r,119,-76
C,2,53714,169,e,105,-64
C,2,53819,183,a,153,-30
C,2,53972,162,l,85,-77
C,2,54057,107, ,164,57
C,2,54221,156,a,56,-100
C,2,54277,141,n,154,13
C,2,54431,139,d,84,-55
C,2,54515,127, ,9244,9117
C,2,63759,148,C,5350,5202
C,2,69109,95,y,83,-12
C,2,69192,173,o,102,-71
C,2,69294,107,u,106,-1
C,2,69400,120,r,80,-40
C,2,69480,144, ,284,140
C,2,69764,109,t,80,-29
C,2,69844,143,h,80,-63
C,2,69924,132,i,55,-77
C,2,69979,124,r,400,276
C,2,70379,154,s,168,14
C,2,70547,130,t,145,15
C,2,70692,130, ,291,161
C,2,70983,127,i,193,66
C,2,71176,114,s,110,-4
C,2,71286,106, ,379,273
C,2,71665,169,q,115,-54
C,2,71780,95,u,103,8
C,2,71883,122,e,97,-25
C,2,71980,121,n,257,136
C,2,72237,134,c,158,24
C,2,72395,101,h,76,-25
C,2,72471,135,e,97,-38
C,2,72568,182,s,210,28
C,2,72778,122, ,508,386
C,2,73286,133,d,125,-8
C,2,73411,126, ,688,562
C,2,74099,140,b,85,-55
C,2,74184,154,y,89,-65
C,2,74273,132, ,145,13
C,2,74418,91,t,63,-28
C,2,74481,100,h,104,4
C,2,74585,135,e,97,-38
C,2,74682,113, ,2322,2209
C,2,77004,81,i,286,205
C,2,77290,125,l,651,526
C,2,77941,109,m,204,95
C,2,78145,122,i,376,254
C,2,78521,118,l,122,4
C,2,78643,113,k,217,104
C,2,78860,76,.,163,87
C,2,79023,96, ,1807,1711
C,2,80830,180,I,113,-67
C,2,80943,152, ,NA,NA
D,1,229,55,F,128,73
D,1,357,100,a,192,92
D,1,549,56,r,252,196
D,1,801,76, ,226,150
D,1,1027,64, ,316,252
D,1,1343,69,o,159,90
D,1,1502,61,u,83,22
D,1,1585,88,t,163,75
D,1,1748,64, ,113,49
D,1,1861,61,i,157,96
D,1,2018,60,n,176,116
D,1,2194,76, ,102,26
D,1,2296,81,t,104,23
D,1,2400,73,h,124,51
D,1,2524,73,e,149,76
D,1,2673,83, ,351,268
D,1,3024,52,u,180,128
D,1,3204,60,n,780,720
D,1,3984,68,c,89,21
D,1,4073,63,h,91,28
D,1,4164,101,a,167,66
D,1,4331,72,r,276,204
D,1,4607,56,t,96,40
D,1,4703,96,e,99,3
D,1,4802,116,d,293,177
D,1,5095,68, ,235,167
D,1,5330,64,b,91,27
D,1,5421,60,a,136,76
D,1,5557,84,c,99,15
D,1,5656,64,k,120,56
D,1,5776,93,w,191,98
D,1,5967,127,a,120,-7
D,1,6087,52,t,116,64
D,1,6203,108,e,93,-15
D,1,6296,67,r,174,107
D,1,6470,112,s,225,113
D,1,6695,72, ,166,94
D,1,6861,72,o,102,30
D,1,6963,53,f,103,50
D,1,7066,76, ,167,91
D,1,7233,56,t,179,123
D,1,7412,84,h,113,29
D,1,7525,68,e,76,8
D,1,7601,101, ,189,88
D,1,7790,60,u,185,125
D,1,7975,76,n,160,84
D,1,8135,69,f,176,107
D,1,8311,141,a,144,3
D,1,8455,145,s,288,143
D,1,8743,75,h,347,272
D,1,9090,60,i,192,132
D,1,9282,56,n,756,700
D,1,10038,76,o,172,96
D,1,10210,77,n,129,52
D,1,10339,148,a,68,-80
D,1,10407,48,b,210,162
D,1,10617,85,l,119,34
D,1,10736,77,e,78,1
D,1,10814,71, ,192,121
D,1,11006,68,e,150,82
D,1,11156,56,n,120,64
D,1,11276,89,d,163,74
D,1,11439,49, ,126,77
D,1,11565,72,o,134,62
D,1,11699,77,f,143,66
D,1,11842,49, ,195,146
D,1,12037,60,t,209,149
D,1,12246,69,h,126,57
D,1,12372,57,e,137,80
D,1,12509,77, ,174,97
D,1,12683,128,w,125,-3
D,1,12808,68,e,173,105
D,1,12981,96,s,104,8
D,1,13085,61,t,119,58
D,1,13204,112,e,88,-24
D,1,13292,92,r,96,4
D,1,13388,57,n,194,137
D,1,13582,89, ,148,59
D,1,13730,121,s,193,72
D,1,13923,76,p,426,350
D,1,14349,56,i,671,615
D,1,15020,64,r,194,130
D,1,15214,93,a,104,11
D,1,15318,72,l,181,109
D,1,15499,91, ,84,-7
D,1,15583,76,a,145,69
D,1,15728,87,r,148,61
D,1,15876,73,m,537,464
D,1,16413,64, ,198,134
D,1,16611,64,o,86,22
D,1,16697,60,f,129,69
D,1,16826,73, ,173,100
D,1,16999,61,t,170,109
D,1,17169,64,h,97,33
D,1,17266,72,e,122,50
D,1,17388,68, ,337,269
D,1,17725,72,G,113,41
D,1,17838,101,a,176,75
D,1,18014,65,l,81,16
D,1,18095,88,a,407,319
D,1,18502,112,x,136,24
D,1,18638,53,y,178,125
D,1,18816,77, ,182,105
D,1,18998,76,l,172,96
D,1,19170,68,i,72,4
D,1,19242,52,e,165,113
D,1,19407,88,s,105,17
D,1,19512,76, ,73,-3
D,1,19585,107,a,139,32
D,1,19724,76, ,107,31
D,1,19831,110,s,156,46
D,1,19987,77,m,76,-1
D,1,20063,116,a,179,63
D,1,20242,53,l,134,81
D,1,20376,76,l,201,125
D,1,20577,96, ,164,68
D,1,20741,64,u,201,137
D,1,20942,68,n,504,436
D,1,21446,80,r,60,-20
D,1,21506,100,e,883,783
D,1,22389,51,g,109,58
D,1,22498,113,a,197,84
D,1,22695,64,r,472,408
D,1,23167,73,d,195,122
D,1,23362,84,e,112,28
D,1,23474,108,d,250,142
D,1,23724,80, ,183,103
D,1,23907,65,y,107,42
D,1,24014,60,e,130,70
D,1,24144,52,l,110,58
D,1,24254,76,l,176,100
D,1,24430,68,o,127,59
D,1,24557,68,w,128,60
D,1,24685,84, ,124,40
D,1,24809,113,s,133,20
D,1,24942,56,u,171,115
D,1,25113,60,n,270,210
D,1,25383,72,.,1224,1152
D,1,26607,143,O,465,322
D,1,27072,76,r,155,79
D,1,27227,60,b,204,144
D,1,27431,60,i,119,59
D,1,27550,74,t,99,25
D,1,27649,57,i,157,100
D,1,27806,45,n,153,108
D,1,27959,60,g,191,131
D,1,28150,76, ,143,67
D,1,28293,77,t,187,110
D,1,28480,68,h,152,84
D,1,28632,73,i,92,19
D,1,28724,91,s,141,50
D,1,28865,68, ,182,114
D,1,29047,144,a,159,15
D,1,29206,56,t,193,137
D,1,29399,80, ,127,47
D,1,29526,108,a,167,59
D,1,29693,72, ,140,68
D,1,29833,85,d,116,31
D,1,29949,72,i,88,16
D,1,30037,104,s,176,72
D,1,30213,68,t,117,49
D,1,30330,104,a,137,33
D,1,30467,68,n,86,18
D,1,30553,80,c,152,72
D,1,30705,104,e,111,7
D,1,30816,65, ,202,137
D,1,31018,68,o,142,74
D,1,31160,76,f,175,99
D,1,31335,80, ,196,116
D,1,31531,72,r,130,58
D,1,31661,60,o,164,104
D,1,31825,65,u,198,133
D,1,32023,64,g,149,85
D,1,32172,68,h,230,162
D,1,32402,76,l,243,167
D,1,32645,56,y,772,716
D,1,33417,92, ,318,226
D,1,33735,60,n,187,127
D,1,33922,64,i,1227,1163
D,1,35149,69,n,136,67
D,1,35285,60,e,145,85
D,1,35430,56,t,156,100
D,1,35586,64,y,1382,1318
D,1,36968,68,t,115,47
D,1,37083,107,w,100,-7
D,1,37183,72,o,206,134
D,1,37389,64, ,259,195
D,1,37648,72,m,295,223
D,1,37943,68,i,416,348
D,1,38359,47,l,150,103
D,1,38509,68,l,206,138
D,1,38715,56,i,198,142
D,1,38913,60,o,172,112
D,1,39085,72,n,295,223
D,1,39380,64, ,194,130
D,1,39574,65,m,194,129
D,1,39768,48,i,193,145
D,1,39961,56,l,97,41
D,1,40058,27,e,155,128
D,1,40213,72,s,137,65
D,1,40350,68, ,155,87
D,1,40505,64,i,105,41
D,1,40610,103,s,124,21
D,1,40734,77, ,108,31
D,1,40842,105,a,148,43
D,1,40990,65,n,235,170
D,1,41225,76, ,209,133
D,1,41434,64,u,647,583
D,1,42081,63,n,352,289
D,1,42433,60,t,439,379
D,1,42872,56,t,108,52
D,1,42980,140,e,104,-36
D,1,43084,129,r,1496,1367
D,1,44580,64,t,167,103
D,1,44747,69,t,118,49
D,1,44865,145,e,108,-37
D,1,44973,105,r,478,373
D,1,45451,68,l,233,165
D,1,45684,61,y,287,226
D,1,45971,76, ,253,177
D,1,46224,56,i,194,138
D,1,46418,68,n,243,175
D,1,46661,108,s,217,109
D,1,46878,56,i,204,148
D,1,47082,65,g,202,137
D,1,47284,56,n,160,104
D,1,47444,69,i,83,14
D,1,47527,80,f,118,38
D,1,47645,65,i,891,826
D,1,48536,68,c,183,115
D,1,48719,96,a,115,19
D,1,48834,65,n,151,86
D,1,48985,81,t,235,154
D,1,49220,81, ,193,112
D,1,49413,73,l,185,112
D,1,49598,67,i,116,49
D,1,49714,52,t,154,102
D,1,49868,56,t,132,76
D,1,50000,75,l,100,25
D,1,50100,68,e,207,139
D,1,50307,53, ,169,116
D,1,50476,65,b,227,162
D,1,50703,88,l,214,126
D,1,50917,63,u,120,57
D,1,51037,88,e,76,-12
D,1,51113,64, ,174,110
D,1,51287,76,g,79,3
D,1,51366,83,r,76,-7
D,1,51442,60,e,172,112
D,1,51614,53,e,362,309
D,1,51976,73,e,878,805
D,1,52854,60,n,197,137
D,1,53051,81, ,197,116
D,1,53248,57,p,122,65
D,1,53370,89,l,152,63
D,1,53522,104,a,123,19
D,1,53645,69,n,197,128
D,1,53842,113,e,220,107
D,1,54062,69,t,509,440
D,1,54571,92, ,115,23
D,1,54686,101,w,104,3
D,1,54790,56,h,174,118
D,1,54964,80,o,434,354
D,1,55398,93,s,210,117
D,1,55608,52,e,186,134
D,1,55794,89, ,118,29
D,1,55912,112,a,149,37
D,1,56061,68,p,139,71
D,1,56200,73,e,601,528
D,1,56801,96,d,80,-16
D,1,56881,100,e,222,122
D,1,57103,77,s,217,140
D,1,57320,69,c,176,107
D,1,57496,92,e,139,47
D,1,57635,61,n,851,790
D,1,58486,57,d,212,155
D,1,58698,80,e,166,86
D,1,58864,60,d,391,331
D,1,59255,76, ,208,132
D,1,59463,76,l,186,110
D,1,59649,64,i,82,18
D,1,59731,76,f,76,0
D,1,59807,112,e,132,20
D,1,59939,73, ,170,97
D,1,60109,112,f,144,32
D,1,60253,61,o,95,34
D,1,60348,65,r,164,99
D,1,60512,64,m,387,323
D,1,60899,107,s,363,256
D,1,61262,93, ,124,31
D,1,61386,84,a,138,54
D,1,61524,88,r,68,-20
D,1,61592,84,e,145,61
D,1,61737,96, ,99,3
D,1,61836,105,s,149,44
D,1,61985,56,o,154,98
D,1,62139,92, ,132,40
D,1,62271,92,a,134,42
D,1,62405,77,m,76,-1
D,1,62481,80,a,682,602
D,1,63163,115,z,119,4
D,1,63282,46,i,132,86
D,1,63414,68,n,185,117
D,1,63599,72,g,230,158
D,1,63829,76,l,238,162
D,1,64067,69,y,193,124
D,1,64260,56, ,196,140
D,1,64456,64,p,113,49
D,1,64569,76,r,141,65
D,1,64710,60,i,191,131
D,1,64901,68,m,194,126
D,1,65095,68,i,237,169
D,1,65332,76,t,208,132
D,1,65540,80,i,84,4
D,1,65624,60,v,172,112
D,1,65796,72,e,195,123
D,1,65991,92, ,334,242
D,1,66325,76,t,255,179
D,1,66580,84,h,731,647
D,1,67311,92,a,183,91
D,1,67494,64,t,178,114
D,1,67672,76, ,299,223
D,1,67971,68,t,180,112
D,1,68151,76,h,107,31
D,1,68258,64,e,82,18
D,1,68340,56,y,131,75
D,1,68471,84, ,126,42
D,1,68597,111,s,84,-27
D,1,68681,76,t,212,136
D,1,68893,52,i,211,159
D,1,69104,24,l,134,110
D,1,69238,64,l,1071,1007
D,1,70309,61,l,307,246
D,1,70616,84, ,172,88
D,1,70788,72,t,92,20
D,1,70880,107,h,95,-12
D,1,70975,81,i,170,89
D,1,71145,56,n,161,105
D,1,71306,75,k,171,96
D,1,71477,88, ,137,49
D,1,71614,104,d,100,-4
D,1,71714,56,i,135,79
D,1,71849,69,g,152,83
D,1,72001,68,i,159,91
D,1,72160,76,t,119,43
D,1,72279,112,a,146,34
D,1,72425,72,l,222,150
D,1,72647,88, ,455,367
D,1,73102,76,w,193,117
D,1,73295,104,a,339,235
D,1,73634,63,t,181,118
D,1,73815,77,c,116,39
D,1,73931,60,h,101,41
D,1,74032,65,e,155,90
D,1,74187,93,s,145,52
D,1,74332,84, ,52,-32
D,1,74384,89,a,114,25
D,1,74498,92,r,77,-15
D,1,74575,99,e,129,30
D,1,74704,93, ,143,50
D,1,74847,129,a,200,71
D,1,75047,69, ,266,197
D,1,75313,67,p,56,-11
D,1,75369,104,r,87,-17
D,1,75456,112,e,229,117
D,1,75685,44,t,135,91
D,1,75820,64,t,164,100
D,1,75984,53,y,189,136
D,1,76173,73, ,203,130
D,1,76376,32,n,31,-1
D,1,76407,69,e,290,221
D,1,76697,140,a,578,438
D,1,77275,52,t,219,167
D,1,77494,77, ,189,112
D,1,77683,60,i,60,0
D,1,77743,75,d,63,-12
D,1,77806,60,e,153,93
D,1,77959,145,a,167,22
D,1,78126,65,.,1329,1264
D,1,79455,84,T,174,90
D,1,79629,81,h,141,60
D,1,79770,105,e,125,20
D,1,79895,93, ,251,158
D,1,80146,68,p,173,105
D,1,80319,88,l,131,43
D,1,80450,101,a,122,21
D,1,80572,69,n,795,726
D,1,81367,88,e,123,35
D,1,81490,53,t,232,179
D,1,81722,76, ,168,92
D,1,81890,76,h,75,-1
D,1,81965,158,a,141,-17
D,1,82106,140,s,2205,2065
D,1,84311,76,",",210,134
D,1,84521,76, ,591,515
D,1,85112,68,o,128,60
D,1,85240,57,r,466,409
D,1,85706,88, ,122,34
D,1,85828,49,r,161,112
D,1,85989,125,a,146,21
D,1,86135,56,t,177,121
D,1,86312,68,h,76,8
D,1,86388,102,e,84,-18
D,1,86472,84,r,165,81
D,1,86637,69, ,135,66
D,1,86772,61,h,29,-32
D,1,86801,104,a,127,23
D,1,86928,93,d,133,40
D,1,87061,61,",",147,86
D,1,87208,81, ,101,20
D,1,87309,104,a,120,16
D,1,87429,53, ,210,157
D,1,87639,80,p,127,47
D,1,87766,80,r,120,40
D,1,87886,64,o,209,145
D,1,88095,56,b,181,125
D,1,88276,87,l,116,29
D,1,88392,73,e,113,40
D,1,88505,60,m,205,145
D,1,88710,52,",",203,151
D,1,88913,76, ,116,40
D,1,89029,76,w,232,156
D,1,89261,116,h,112,-4
D,1,89373,84,i,107,23
D,1,89480,77,c,109,32
D,1,89589,62,h,155,93
D,1,89744,100, ,116,16
D,1,89860,81,w,130,49
D,1,89990,140,a,112,-28
D,1,90102,116,s,150,34
D,1,90252,81, ,194,113
D,1,90446,69,t,185,116
D,1,90631,76,h,135,59
D,1,90766,73,i,109,36
D,1,90875,116,s,88,-28
D,1,90963,76, ,841,765
D,1,91804,177,:,410,233
D,1,92214,89, ,250,161
D,1,92464,28,m,667,639
D,1,93131,64,o,116,52
D,1,93247,116,s,145,29
D,1,93392,68,t,159,91
D,1,93551,64, ,165,101
D,1,93716,72,o,108,36
D,1,93824,77,f,94,17
D,1,93918,72, ,155,83
D,1,94073,68,t,179,111
D,1,94252,104,h,188,84
D,1,94440,96,e,124,28
D,1,94564,60, ,199,139
D,1,94763,88,p,149,61
D,1,94912,108,e,134,26
D,1,95046,52,o,212,160
D,1,95258,84,p,193,109
D,1,95451,72,l,148,76
D,1,95599,56,e,197,141
D,1,95796,64, ,143,79
D,1,95939,68,o,176,108
D,1,96115,68,n,210,142
D,1,96325,80, ,306,226
D,1,96631,61,i,120,59
D,1,96751,65,t,137,72
D,1,96888,88, ,167,79
D,1,97055,72,w,226,154
D,1,97281,69,e,152,83
D,1,97433,99,r,84,-15
D,1,97517,124,e,243,119
D,1,97760,77, ,180,103
D,1,97940,56,u,178,122
D,1,98118,44,n,175,131
D,1,98293,84, ,230,146
D,1,98523,72,h,138,66
D,1,98661,100,a,127,27
D,1,98788,40,p,125,85
D,1,98913,72,p,245,173
D,1,99158,64,y,151,87
D,1,99309,84, ,99,15
D,1,99408,115,f,112,-3
D,1,99520,80,o,174,94
D,1,99694,80,r,1885,1805
D,1,101579,72,h,99,27
D,1,101678,115,a,104,-11
D,1,101782,44,p,130,86
D,1,101912,64,p,209,145
D,1,102121,64,y,227,163
D,1,102348,96, ,143,47
D,1,102491,107,f,88,-19
D,1,102579,72,o,169,97
D,1,102748,69,r,153,84
D,1,102901,84, ,548,464
D,1,103449,65,p,201,136
D,1,103650,96,r,107,11
D,1,103757,113,e,522,409
D,1,104279,52,t,130,78
D,1,104409,72,t,181,109
D,1,104590,88,y,136,48
D,1,104726,76, ,190,114
D,1,104916,80,m,182,102
D,1,105098,72,u,121,49
D,1,105219,87,c,56,-31
D,1,105275,63,h,124,61
D,1,105399,68, ,143,75
D,1,105542,72,o,108,36
D,1,105650,84,f,91,7
D,1,105741,69, ,163,94
D,1,105904,60,t,182,122
D,1,106086,81,h,124,43
D,1,106210,59,e,170,111
D,1,106380,99, ,272,173
D,1,106652,72,t,98,26
D,1,106750,64,i,209,145
D,1,106959,60,m,121,61
D,1,107080,69,e,220,151
D,1,107300,36,",",929,893
D,1,108229,108,.,332,224
D,1,108561,100, ,378,278
D,1,108939,100,M,141,41
D,1,109080,109,a,96,-13
D,1,109176,67,n,183,116
D,1,109359,68,y,150,82
D,1,109509,114, ,183,69
D,1,109692,107,s,100,-7
D,1,109792,39,o,161,122
D,1,109953,76,l,197,121
D,1,110150,73,u,133,60
D,1,110283,64,t,95,31
D,1,110378,100,i,73,-27
D,1,110451,115,o,139,24
D,1,110590,85,n,104,19
D,1,110694,77,s,158,81
D,1,110852,104, ,115,11
D,1,110967,93,w,246,153
D,1,111213,111,e,112,1
D,1,111325,103,r,92,-11
D,1,111417,128,e,849,721
D,1,112266,92, ,132,40
D,1,112398,116,s,112,-4
D,1,112510,57,u,180,123
D,1,112690,56,g,120,64
D,1,112810,72,g,65,-7
D,1,112875,51,e,174,123
D,1,113049,77,s,110,33
D,1,113159,49,t,88,39
D,1,113247,79,e,75,-4
D,1,113322,141,d,192,51
D,1,113514,69, ,95,26
D,1,113609,108,f,112,4
D,1,113721,73,o,125,52
D,1,113846,85,r,139,54
D,1,113985,72, ,178,106
D,1,114163,60,t,191,131
D,1,114354,72,h,56,-16
D,1,114410,84,i,121,37
D,1,114531,116,s,101,-15
D,1,114632,51, ,156,105
D,1,114788,72,p,86,14
D,1,114874,64,r,95,31
D,1,114969,61,o,154,93
D,1,115123,57,b,180,123
D,1,115303,72,l,105,33
D,1,115408,76,e,98,22
D,1,115506,73,m,238,165
D,1,115744,84, ,597,513
D,1,116341,85,",",177,92
D,1,116518,65, ,137,72
D,1,116655,73,b,115,42
D,1,116770,64,u,102,38
D,1,116872,68,t,134,66
D,1,117006,65, ,165,100
D,1,117171,36,m,137,101
D,1,117308,68,o,133,65
D,1,117441,109,s,128,19
D,1,117569,65,t,142,77
D,1,117711,77, ,169,92
D,1,117880,76,o,130,54
D,1,118010,51,f,71,20
D,1,118081,72, ,176,104
D,1,118257,73,t,191,118
D,1,118448,84,h,112,28
D,1,118560,69,e,196,127
D,1,118756,84,s,184,100
D,1,118940,57,e,182,125
D,1,119122,85, ,168,83
D,1,119290,72,w,375,303
D,1,119665,105,e,123,18
D,1,119788,103,r,93,-10
D,1,119881,124,e,444,320
D,1,120325,60, ,214,154
D,1,120539,80,l,84,4
D,1,120623,88,a,134,46
D,1,120757,97,r,143,46
D,1,120900,55,g,201,146
D,1,121101,69,e,1979,1910
D,1,123080,68,l,1219,1151
D,1,124299,67,y,276,209
D,1,124575,92, ,148,56
D,1,124723,85,c,106,21
D,1,124829,58,o,178,120
D,1,125007,61,n,425,364
D,1,125432,77,c,183,106
D,1,125615,124,e,112,-12
D,1,125727,96,r,168,72
D,1,125895,60,n,144,84
D,1,126039,104,e,103,-1
D,1,126142,96,d,680,584
D,1,126822,80, ,155,75
D,1,126977,85,w,100,15
D,1,127077,60,i,135,75
D,1,127212,69,t,118,49
D,1,127330,64,h,166,102
D,1,127496,84, ,166,82
D,1,127662,72,t,200,128
D,1,127862,89,h,88,-1
D,1,127950,108,e,134,26
D,1,128084,72, ,256,184
D,1,128340,80,m,183,103
D,1,128523,69,o,81,12
D,1,128604,56,v,166,110
D,1,128770,90,e,126,36
D,1,128896,68,m,100,32
D,1,128996,88,e,110,22
D,1,129106,64,n,109,45
D,1,129215,56,t,210,154
D,1,129425,100,s,179,79
D,1,129604,69, ,178,109
D,1,129782,72,o,280,208
D,1,130062,48, ,461,413
D,1,130523,72,f,183,111
D,1,130706,85, ,185,100
D,1,130891,116,s,144,28
D,1,131035,66,m,65,-1
D,1,131100,103,a,151,48
D,1,131251,48,l,149,101
D,1,131400,72,l,184,112
D,1,131584,92, ,202,110
D,1,131786,64,g,83,19
D,1,131869,79,r,60,-19
D,1,131929,84,e,196,112
D,1,132125,73,e,131,58
D,1,132256,53,e,2028,1975
D,1,134284,72,n,230,158
D,1,134514,84, ,223,139
D,1,134737,79,p,177,98
D,1,134914,92,e,631,539
D,1,135545,100,e,101,1
D,1,135646,31,i,568,537
D,1,136214,68,i,117,49
D,1,136331,81,e,294,213
D,1,136625,60,c,204,144
D,1,136829,60,e,220,160
D,1,137049,84,s,289,205
D,1,137338,72, ,194,122
D,1,137532,72,o,88,16
D,1,137620,76,f,127,51
D,1,137747,49, ,170,121
D,1,137917,72,p,79,7
D,1,137996,120,a,113,-7
D,1,138109,60,p,108,48
D,1,138217,122,e,101,-21
D,1,138318,104,r,266,162
D,1,138584,84,",",231,147
D,1,138815,88, ,103,15
D,1,138918,108,w,89,-19
D,1,139007,115,h,95,-20
D,1,139102,124,i,85,-39
D,1,139187,83,c,91,8
D,1,139278,77,h,238,161
D,1,139516,84, ,180,96
D,1,139696,64,i,124,60
D,1,139820,105,s,128,23
D,1,139948,88, ,215,127
D,1,140163,52,o,132,80
D,1,140295,64,o,75,11
D,1,140370,69,d,659,590
D,1,141029,45,d,144,99
D,1,141173,68,d,104,36
D,1,141277,56, ,164,108
D,1,141441,76,b,53,-23
D,1,141494,60,e,246,186
D,1,141740,117,c,1524,1407
D,1,143264,85,c,172,87
D,1,143436,136,a,173,37
D,1,143609,60,u,127,67
D,1,143736,88,s,197,109
D,1,143933,64,e,135,71
D,1,144068,76, ,173,97
D,1,144241,60,o,178,118
D,1,144419,60,n,175,115
D,1,144594,88, ,110,22
D,1,144704,52,t,113,61
D,1,144817,68,h,98,30
D,1,144915,73,e,93,20
D,1,145008,93, ,113,20
D,1,145121,85,w,88,3
D,1,145209,68,h,156,88
D,1,145365,68,o,204,136
D,1,145569,88,l,125,37
D,1,145694,81,e,221,140
D,1,145915,74, ,157,83
D,1,146072,68,i,97,29
D,1,146169,65,t,143,78
D,1,146312,101, ,135,34
D,1,146447,76,w,173,97
D,1,146620,104,a,68,-36
D,1,146688,113,s,241,128
D,1,146929,68,n,230,162
D,1,147159,99,;,96,-3
D,1,147255,79,t,836,757
D,1,148091,64,',127,63
D,1,148218,81,t,266,185
D,1,148484,60, ,450,390
D,1,148934,84,t,141,57
D,1,149075,72,h,97,25
D,1,149172,64,e,115,51
D,1,149287,84, ,96,12
D,1,149383,121,s,139,18
D,1,149522,73,m,105,32
D,1,149627,121,a,140,19
D,1,149767,60,l,151,91
D,1,149918,72,l,332,260
D,1,150250,68, ,204,136
D,1,150454,64,g,81,17
D,1,150535,88,r,178,90
D,1,150713,56,e,161,105
D,1,150874,80,e,191,111
D,1,151065,59,n,401,342
D,1,151466,80, ,223,143
D,1,151689,80,p,192,112
D,1,151881,73,i,115,42
D,1,151996,49,e,156,107
D,1,152152,65,c,145,80
D,1,152297,61,e,177,116
D,1,152474,108,s,184,76
D,1,152658,83, ,141,58
D,1,152799,73,o,105,32
D,1,152904,65,f,119,54
D,1,153023,41, ,172,131
D,1,153195,72,p,65,-7
D,1,153260,104,a,159,55
D,1,153419,65,p,98,33
D,1,153517,116,e,100,-16
D,1,153617,104,r,131,27
D,1,153748,69, ,208,139
D,1,153956,60,t,176,116
D,1,154132,69,h,76,7
D,1,154208,141,a,112,-29
D,1,154320,60,t,152,92
D,1,154472,97, ,139,42
D,1,154611,85,w,211,126
D,1,154822,100,e,96,-4
D,1,154918,112,r,96,-16
D,1,155014,120,e,417,297
D,1,155431,73, ,170,97
D,1,155601,72,h,93,21
D,1,155694,96,a,978,882
D,1,156672,60,u,196,136
D,1,156868,67,n,400,333
D,1,157268,69,h,101,32
D,1,157369,109,a,120,11
D,1,157489,53,p,122,69
D,1,157611,77,p,270,193
D,1,157881,52,y,1934,1882
D,1,159815,60,.,NA,NA
D,2,167,83,H,161,78
D,2,328,99,o,76,-23
D,2,404,72,t,139,67
D,2,543,81, ,171,90
D,2,714,72,p,132,60
D,2,846,72,o,786,714
D,2,1632,60,p,118,58
D,2,1750,83,o,148,65
D,2,1898,72,t,172,100
D,2,2070,73, ,195,122
D,2,2265,76,i,154,78
D,2,2419,72,s,179,107
D,2,2598,88, ,361,273
D,2,2959,96,a,612,516
D,2,3571,60, ,212,152
D,2,3783,72,b,166,94
D,2,3949,80,e,340,260
D,2,4289,70,l,755,685
D,2,5044,68,o,164,96
D,2,5208,68,v,148,80
D,2,5356,40,e,109,69
D,2,5465,89,d,709,620
D,2,6174,84, ,236,152
D,2,6410,108,c,147,39
D,2,6557,52,o,186,134
D,2,6743,56,m,124,68
D,2,6867,80,m,196,116
D,2,7063,60,u,181,121
D,2,7244,72,n,108,36
D,2,7352,104,a,136,32
D,2,7488,69,l,233,164
D,2,7721,84, ,160,76
D,2,7881,89,d,124,35
D,2,8005,65,i,1099,1034
D,2,9104,60,n,258,198
D,2,9362,52,i,176,124
D,2,9538,69,n,210,141
D,2,9748,65,g,305,240
D,2,10053,64, ,2226,2162
D,2,12279,88,e,234,146
D,2,12513,89,x,205,116
D,2,12718,88,p,176,88
D,2,12894,112,e,72,-40
D,2,12966,129,r,1019,890
D,2,13985,72,i,258,186
D,2,14243,96,e,125,29
D,2,14368,36,n,118,82
D,2,14486,97,c,160,63
D,2,14646,109,e,123,14
D,2,14769,88, ,226,138
D,2,14995,72,o,340,268
D,2,15335,72,r,170,98
D,2,15505,85,i,289,204
D,2,15794,81,g,247,166
D,2,16041,60,i,185,125
D,2,16226,52,n,116,64
D,2,16342,113,a,459,346
D,2,16801,55,i,847,792
D,2,17648,79,t,132,53
D,2,17780,69,i,214,145
D,2,17994,71,n,221,150
D,2,18215,101,g,268,167
D,2,18483,105, ,218,113
D,2,18701,152,f,132,-20
D,2,18833,135,r,120,-15
D,2,18953,52,o,204,152
D,2,19157,73,m,176,103
D,2,19333,93, ,381,288
D,2,19714,72,E,261,189
D,2,19975,124,a,105,-19
D,2,20080,107,s,174,67
D,2,20254,71,t,350,279
D,2,20604,81, ,350,269
D,2,20954,127,A,116,-11
D,2,21070,144,s,159,15
D,2,21229,84,i,151,67
D,2,21380,112,a,815,703
D,2,22195,40,.,287,247
D,2,22482,76, ,6978,6902
D,2,29460,84,T,165,81
D,2,29625,82,y,238,156
D,2,29863,92,p,165,73
D,2,30028,80,i,282,202
D,2,30310,72,c,197,125
D,2,30507,104,a,301,197
D,2,30808,61,l,134,73
D,2,30942,104,l,281,177
D,2,31223,108,y,200,92
D,2,31423,108, ,163,55
D,2,31586,120,e,100,-20
D,2,31686,68,n,199,131
D,2,31885,112,j,160,48
D,2,32045,97,o,237,140
D,2,32282,88,y,191,103
D,2,32473,155,e,148,-7
D,2,32621,142,d,478,336
D,2,33099,80, ,500,420
D,2,33599,72,i,224,152
D,2,33823,68,n,238,170
D,2,34061,64, ,233,169
D,2,34294,113,g,188,75
D,2,34482,111,r,108,-3
D,2,34590,71,o,573,502
D,2,35163,108,u,304,196
D,2,35467,76,p,123,47
D,2,35590,132,s,1317,1185
D,2,36907,76,",",301,225
D,2,37208,60, ,195,135
D,2,37403,84,h,228,144
D,2,37631,73,o,132,59
D,2,37763,104,t,520,416
D,2,38283,68,p,155,87
D,2,38438,80,o,147,67
D,2,38585,112,t,420,308
D,2,39005,76, ,191,115
D,2,39196,72,i,208,136
D,2,39404,56,n,438,382
D,2,39842,80,v,201,121
D,2,40043,60,o,249,189
D,2,40292,55,l,526,471
D,2,40818,80,v,275,195
D,2,41093,72,e,248,176
D,2,41341,96,s,372,276
D,2,41713,84, ,225,141
D,2,41938,56,a,171,115
D,2,42109,60, ,836,776
D,2,42945,87,s,440,353
D,2,43385,64,i,238,174
D,2,43623,61,m,149,88
D,2,43772,73,m,111,38
D,2,43883,164,e,137,-27
D,2,44020,120,r,144,24
D,2,44164,56,i,170,114
D,2,44334,65,n,211,146
D,2,44545,72,g,286,214
D,2,44831,73, ,497,424
D,2,45328,84,p,193,109
D,2,45521,80,o,1368,1288
D,2,46889,76,t,171,95
D,2,47060,85, ,154,69
D,2,47214,101,o,124,23
D,2,47338,80,f,123,43
D,2,47461,72, ,207,135
D,2,47668,84,b,137,53
D,2,47805,116,r,128,12
D,2,47933,85,o,148,63
D,2,48081,93,t,162,69
D,2,48243,73,h,268,195
D,2,48511,73, ,208,135
D,2,48719,105,p,156,51
D,2,48875,105,l,539,434
D,2,49414,96,a,188,92
D,2,49602,80,c,166,86
D,2,49768,76,e,315,239
D,2,50083,56,d,461,405
D,2,50544,90, ,189,99
D,2,50733,96,a,140,44
D,2,50873,97,t,166,69
D,2,51039,109, ,108,-1
D,2,51147,97,t,224,127
D,2,51371,95,h,103,8
D,2,51474,101,e,115,14
D,2,51589,69, ,126,57
D,2,51715,53,c,140,87
D,2,51855,92,e,73,-19
D,2,51928,63,n,217,154
D,2,52145,69,t,90,21
D,2,52235,148,e,128,-20
D,2,52363,116,r,100,-16
D,2,52463,84, ,168,84
D,2,52631,88,o,125,37
D,2,52756,88,f,68,-20
D,2,52824,96, ,185,89
D,2,53009,68,t,197,129
D,2,53206,72,h,64,-8
D,2,53270,109,e,136,27
D,2,53406,29, ,72,43
D,2,53478,83,t,123,40
D,2,53601,124,a,120,-4
D,2,53721,56,b,151,95
D,2,53872,49,e,791,742
D,2,54663,84,l,96,12
D,2,54759,84,e,167,83
D,2,54926,72,",",254,182
D,2,55180,89, ,210,121
D,2,55390,72,w,222,150
D,2,55612,113,e,120,7
D,2,55732,108,r,96,-12
D,2,55828,104,e,950,846
D,2,56778,76,h,56,-20
D,2,56834,113,e,92,-21
D,2,56926,116,r,103,-13
D,2,57029,145,e,622,477
D,2,57651,76, ,3668,3592
D,2,61319,96,p,111,15
D,2,61430,112,e,136,24
D,2,61566,94,o,72,-22
D,2,61638,104,p,168,64
D,2,61806,93,l,220,127
D,2,62026,56,e,420,364
D,2,62446,88, ,235,147
D,2,62681,96,c,149,53
D,2,62830,53,o,149,96
D,2,62979,52,o,130,78
D,2,63109,101,k,522,421
D,2,63631,69, ,163,94
D,2,63794,123,a,104,-19
D,2,63898,64,n,289,225
D,2,64187,48, ,176,128
D,2,64363,100,a,198,98
D,2,64561,51,r,146,95
D,2,64707,57,r,127,70
D,2,64834,135,a,128,-7
D,2,64962,76,y,498,422
D,2,65460,64, ,199,135
D,2,65659,68,o,102,34
D,2,65761,72,f,125,53
D,2,65886,60, ,228,168
D,2,66114,73,f,227,154
D,2,66341,107,r,88,-19
D,2,66429,107,e,197,90
D,2,66626,106,s,125,19
D,2,66751,68,h,402,334
D,2,67153,84, ,167,83
D,2,67320,64,i,172,108
D,2,67492,60,n,154,94
D,2,67646,76,g,99,23
D,2,67745,95,r,79,-16
D,2,67824,85,e,179,94
D,2,68003,124,d,128,4
D,2,68131,72,i,469,397
D,2,68600,68,e,83,15
D,2,68683,64,n,124,60
D,2,68807,52,t,202,150
D,2,69009,108,s,1200,1092
D,2,70209,53,",",253,200
D,2,70462,79, ,209,130
D,2,70671,120,s,124,4
D,2,70795,80,u,145,65
D,2,70940,112,c,115,3
D,2,71055,73,h,286,213
D,2,71341,88, ,556,468
D,2,71897,138,a,102,-36
D,2,71999,140,s,166,26
D,2,72165,88, ,261,173
D,2,72426,107,t,111,4
D,2,72537,85,h,248,163
D,2,72785,56,i,185,129
D,2,72970,44,n,259,215
D,2,73229,96,l,284,188
D,2,73513,89,y,299,210
D,2,73812,96, ,259,163
D,2,74071,124,s,488,364
D,2,74559,79,l,218,139
D,2,74777,68,i,237,169
D,2,75014,88,c,163,75
D,2,75177,115,e,96,-19
D,2,75273,107,d,225,118
D,2,75498,76, ,228,152
D,2,75726,44,m,107,63
D,2,75833,71,e,211,140
D,2,76044,77,a,132,55
D,2,76176,69,t,322,253
D,2,76498,79,",",260,181
D,2,76758,92, ,517,425
D,2,77275,64,v,186,122
D,2,77461,73,e,118,45
D,2,77579,68,g,96,28
D,2,77675,60,e,304,244
D,2,77979,64,t,156,92
D,2,78135,133,a,134,1
D,2,78269,51,b,218,167
D,2,78487,81,l,136,55
D,2,78623,65,e,235,170
D,2,78858,105,s,203,98
D,2,79061,93,",",261,168
D,2,79322,68, ,128,60
D,2,79450,131,a,72,-59
D,2,79522,83,n,151,68
D,2,79673,93,d,110,17
D,2,79783,68, ,563,495
D,2,80346,64,n,222,158
D,2,80568,40,o,121,81
D,2,80689,65,o,108,43
D,2,80797,100,d,108,8
D,2,80905,61,l,108,47
D,2,81013,61,e,173,112
D,2,81186,113,s,2798,2685
D,2,83984,69,.,14991,14922
D,2,98975,72, ,56712,56640
D,2,155687,116,T,185,69
D,2,155872,89,h,145,56
D,2,156017,92,e,188,96
D,2,156205,104, ,237,133
D,2,156442,88,c,108,20
D,2,156550,52,o,186,134
D,2,156736,40,m,119,79
D,2,156855,69,m,256,187
D,2,157111,23,u,233,210
D,2,157344,88,t,224,136
D,2,157568,149,a,128,-21
D,2,157696,45,l,604,559
D,2,158300,56, ,185,129
D,2,158485,80,n,95,15
D,2,158580,112,a,169,57
D,2,158749,56,t,162,106
D,2,158911,80,u,95,15
D,2,159006,95,r,76,-19
D,2,159082,132,e,133,1
D,2,159215,83, ,152,69
D,2,159367,100,o,119,19
D,2,159486,80,f,109,29
D,2,159595,116, ,507,391
D,2,160102,60,h,157,97
D,2,160259,64,o,102,38
D,2,160361,81,t,113,32
D,2,160474,77,p,209,132
D,2,160683,68,o,103,35
D,2,160786,60,t,200,140
D,2,160986,72, ,208,136
D,2,161194,75,m,72,-3
D,2,161266,125,a,111,-14
D,2,161377,73,k,77,4
D,2,161454,91,e,92,1
D,2,161546,95, ,107,12
D,2,161653,77,i,101,24
D,2,161754,84,t,117,33
D,2,161871,80, ,7898,7818
D,2,169769,104,s,843,739
D,2,170612,129,a,112,-17
D,2,170724,65,n,206,141
D,2,170930,68, ,136,68
D,2,171066,64,i,79,15
D,2,171145,117,d,96,-21
D,2,171241,93,e,123,30
D,2,171364,156,a,140,-16
D,2,171504,64,l,584,520
D,2,172088,68, ,1129,1061
D,2,173217,92,c,100,8
D,2,173317,69,h,167,98
D,2,173484,99,o,187,88
D,2,173671,71,i,60,-11
D,2,173731,107,c,194,87
D,2,173925,107,e,4476,4369
D,2,178401,85, ,145,60
D,2,178546,103,f,67,-36
D,2,178613,92,o,156,64
D,2,178769,85,r,428,343
D,2,179197,114, ,244,130
D,2,179441,68,g,137,69
D,2,179578,115,a,115,0
D,2,179693,57,t,200,143
D,2,179893,69,h,86,17
D,2,179979,144,e,112,-32
D,2,180091,108,r,72,-36
D,2,180163,48,i,175,127
D,2,180338,40,n,162,122
D,2,180500,73,g,199,126
D,2,180699,81, ,117,36
D,2,180816,69,f,123,54
D,2,180939,168,a,105,-63
D,2,181044,64,m,168,104
D,2,181212,61,i,195,134
D,2,181407,81,l,478,397
D,2,181885,68,y,150,82
D,2,182035,85, ,84,-1
D,2,182119,123,a,127,4
D,2,182246,53,n,66,13
D,2,182312,90,d,114,24
D,2,182426,70, ,89,19
D,2,182515,136,f,140,4
D,2,182655,89,r,103,14
D,2,182758,77,i,102,25
D,2,182860,164,e,144,-20
D,2,183004,51,n,40,-11
D,2,183044,112,d,5979,5867
D,2,189023,72,s,622,550
D,2,189645,52,.,10009,9957
D,2,199654,97, ,626,529
D,2,200280,80,H,122,42
D,2,200402,77,a,180,103
D,2,200582,76,v,48,-28
D,2,200630,63,i,178,115
D,2,200808,53,n,166,113
D,2,200974,57,g,158,101
D,2,201132,88, ,139,51
D,2,201271,64,h,177,113
D,2,201448,72,o,230,158
D,2,201678,36,p,631,595
D,2,202309,68,t,121,53
D,2,202430,68,p,122,54
D,2,202552,72,o,118,46
D,2,202670,68,t,142,74
D,2,202812,80, ,198,118
D,2,203010,76,g,88,12
D,2,203098,60,r,174,114
D,2,203272,120,a,180,60
D,2,203452,132,d,168,36
D,2,203620,32,a,601,569
D,2,204221,79,u,100,21
D,2,204321,108,a,134,26
D,2,204455,52,l,127,75
D,2,204582,57,l,202,145
D,2,204784,65,y,149,84
D,2,204933,72, ,159,87
D,2,205092,76,b,76,0
D,2,205168,48,e,156,108
D,2,205324,76,c,761,685
D,2,206085,100,a,619,519
D,2,206704,64,o,155,91
D,2,206859,68,m,80,12
D,2,206939,52,e,121,69
D,2,207060,73, ,155,82
D,2,207215,88,a,218,130
D,2,207433,56, ,726,670
D,2,208159,76,s,76,0
D,2,208235,72,o,100,28
D,2,208335,116,c,100,-16
D,2,208435,64,i,112,48
D,2,208547,108,a,120,12
D,2,208667,65,l,199,134
D,2,208866,73, ,7236,7163
D,2,216102,93,s,135,42
D,2,216237,84,o,130,46
D,2,216367,101,c,115,14
D,2,216482,85,i,979,894
D,2,217461,84,a,601,517
D,2,218062,83,c,166,83
D,2,218228,65,t,200,135
D,2,218428,77,i,108,31
D,2,218536,92,v,81,-11
D,2,218617,76,i,145,69
D,2,218762,92,t,96,4
D,2,218858,64,y,493,429
D,2,219351,68, ,226,158
D,2,219577,56,t,196,140
D,2,219773,68,h,108,40
D,2,219881,92,a,95,3
D,2,219976,69,t,169,100
D,2,220145,100, ,142,42
D,2,220287,117,f,137,20
D,2,220424,73,o,162,89
D,2,220586,69,r,4211,4142
D,2,224797,104,s,157,53
D,2,224954,60,t,98,38
D,2,225052,120,e,100,-20
D,2,225152,116,r,479,363
D,2,225631,61, ,4085,4024
D,2,229716,100,s,333,233
D,2,230049,97, ,145,48
D,2,230194,84,c,92,8
D,2,230286,52,o,141,89
D,2,230427,60,n,138,78
D,2,230565,64,n,24,-40
D,2,230589,71,e,177,106
D,2,230766,65,c,178,113
D,2,230944,103,t,96,-7
D,2,231040,111,i,75,-36
D,2,231115,105,o,161,56
D,2,231276,72,n,199,127
D,2,231475,92, ,103,11
D,2,231578,165,a,129,-36
D,2,231707,40,n,90,50
D,2,231797,112,d,141,29
D,2,231938,84, ,223,139
D,2,232161,140,s,170,30
D,2,232331,59,t,72,13
D,2,232403,96,r,75,-21
D,2,232478,137,e,265,128
D,2,232743,76,n,906,830
D,2,233649,64,g,224,160
D,2,233873,65,t,236,171
D,2,234109,61,h,136,75
D,2,234245,93,e,109,16
D,2,234354,65,n,241,176
D,2,234595,69, ,167,98
D,2,234762,59,b,170,111
D,2,234932,52,o,128,76
D,2,235060,68,n,96,28
D,2,235156,96,d,76,-20
D,2,235232,141,s,260,119
D,2,235492,55,.,6378,6323
D,2,241870,72,s,42684,42612
D,2,284554,81, ,19008,18927
D,2,303562,117,F,129,12
D,2,303691,76,u,291,215
D,2,303982,68,t,193,125
D,2,304175,80,h,95,15
D,2,304270,115,e,83,-32
D,2,304353,120,r,152,32
D,2,304505,73,m,177,104
D,2,304682,60,o,81,21
D,2,304763,97,r,60,-37
D,2,304823,125,e,140,15
D,2,304963,57,",",405,348
D,2,305368,92, ,780,688
D,2,306148,88,t,14923,14835
D,2,321071,63,S,926,863
D,2,321997,75,o,277,202
D,2,322274,76, ,180,104
D,2,322454,72,i,199,127
D,2,322653,77,t,308,231
D,2,322961,105, ,194,89
D,2,323155,89,c,92,3
D,2,323247,80,o,158,78
D,2,323405,44,u,202,158
D,2,323607,80,l,124,44
D,2,323731,84,d,148,64
D,2,323879,57, ,1097,1040
D,2,324976,53,o,131,78
D,2,325107,61,f,162,101
D,2,325269,59,f,164,105
D,2,325433,131,e,108,-23
D,2,325541,108,r,5097,4989
D,2,330638,96, ,133,37
D,2,330771,117,s,150,33
D,2,330921,81, ,639,558
D,2,331560,106,a,95,-11
D,2,331655,80, ,222,142
D,2,331877,80,h,114,34
D,2,331991,65,e,146,81
D,2,332137,111,a,100,-11
D,2,332237,80,l,227,147
D,2,332464,84,t,83,-1
D,2,332547,130,h,151,21
D,2,332698,104,y,268,164
D,2,332966,108, ,5515,5407
D,2,338481,132,a,104,-28
D,2,338585,63,n,164,101
D,2,338749,92,d,196,104
D,2,338945,60, ,193,133
D,2,339138,76,n,174,98
D,2,339312,68,u,193,125
D,2,339505,69,t,103,34
D,2,339608,97,r,132,35
D,2,339740,88,i,619,531
D,2,340359,72,t,83,11
D,2,340442,65,i,180,115
D,2,340622,61,o,134,73
D,2,340756,76,u,90,14
D,2,340846,109,s,131,22
D,2,340977,60, ,177,117
D,2,341154,72,m,39,-33
D,2,341193,108,e,205,97
D,2,341398,127,a,107,-20
D,2,341505,57,l,222,165
D,2,341727,92,.,282,190
D,2,342009,80, ,NA,NA
E,1,148,76,F,232,156
E,1,380,104,a,93,-11
E,1,473,75,r,79,4
E,1,552,65, ,73,8
E,1,625,53,o,153,100
E,1,778,76,u,68,-8
E,1,846,56,t,32,-24
E,1,878,89, ,123,34
E,1,1001,68,i,64,-4
E,1,1065,36,n,12,-24
E,1,1077,108, ,104,-4
E,1,1181,64,t,72,8
E,1,1253,69,h,95,26
E,1,1348,108,e,72,-36
E,1,1420,92, ,414,322
E,1,1834,69,u,131,62
E,1,1965,64,n,60,-4
E,1,2025,49,c,109,60
E,1,2134,64,h,76,12
E,1,2210,100,a,68,-32
E,1,2278,64,r,100,36
E,1,2378,69,t,150,81
E,1,2528,80,e,68,-12
E,1,2596,116,d,128,12
E,1,2724,73, ,167,94
E,1,2891,61,b,142,81
E,1,3033,115,a,83,-32
E,1,3116,64,c,40,-24
E,1,3156,72,k,141,69
E,1,3297,169,w,112,-57
E,1,3409,100,a,76,-24
E,1,3485,84,t,129,45
E,1,3614,113,e,93,-20
E,1,3707,64,r,112,48
E,1,3819,109,s,76,-33
E,1,3895,76, ,151,75
E,1,4046,56,o,59,3
E,1,4105,65,f,147,82
E,1,4252,108, ,97,-11
E,1,4349,72,t,51,-21
E,1,4400,77,h,201,124
E,1,4601,73,e,167,94
E,1,4768,93, ,157,64
E,1,4925,89,u,933,844
E,1,5858,85,n,177,92
E,1,6035,99,f,75,-24
E,1,6110,76,a,117,41
E,1,6227,69,s,162,93
E,1,6389,64,h,198,134
E,1,6587,101,o,522,421
E,1,7109,85,i,180,95
E,1,7289,105,o,48,-57
E,1,7337,76,n,80,4
E,1,7417,104,a,60,-44
E,1,7477,80,b,88,8
E,1,7565,64,l,125,61
E,1,7690,65,e,325,260
E,1,8015,69, ,3322,3253
E,1,11337,67,e,82,15
E,1,11419,64,n,80,16
E,1,11499,61,d,147,86
E,1,11646,61, ,108,47
E,1,11754,56,o,73,17
E,1,11827,48,f,72,24
E,1,11899,79, ,64,-15
E,1,11963,55,t,48,-7
E,1,12011,84,h,124,40
E,1,12135,52,e,28,-24
E,1,12163,96, ,80,-16
E,1,12243,120,w,96,-24
E,1,12339,100,e,143,43
E,1,12482,81,s,129,48
E,1,12611,80,t,111,31
E,1,12722,120,e,92,-28
E,1,12814,88,r,84,-4
E,1,12898,88, ,48,-40
E,1,12946,68,n,116,48
E,1,13062,72,s,80,8
E,1,13142,65,p,156,91
E,1,13298,83,i,76,-7
E,1,13374,99,r,54,-45
E,1,13428,78,a,66,-12
E,1,13494,76,l,98,22
E,1,13592,108, ,65,-43
E,1,13657,115,a,87,-28
E,1,13744,56,r,102,46
E,1,13846,68,m,120,52
E,1,13966,76, ,113,37
E,1,14079,60,o,227,167
E,1,14306,80,f,141,61
E,1,14447,84, ,60,-24
E,1,14507,60,t,47,-13
E,1,14554,77,h,100,23
E,1,14654,76,e,40,-36
E,1,14694,88, ,2564,2476
E,1,17258,44,n,484,440
E,1,17742,56,r,102,46
E,1,17844,64,n,76,12
E,1,17920,60, ,106,46
E,1,18026,74,s,73,-1
E,1,18099,64,p,163,99
E,1,18262,60,i,104,44
E,1,18366,104,r,84,-20
E,1,18450,100,a,88,-12
E,1,18538,56,l,228,172
E,1,18766,68, ,190,122
E,1,18956,123,a,108,-15
E,1,19064,64,r,92,28
E,1,19156,69,m,112,43
E,1,19268,57, ,85,28
E,1,19353,79,o,76,-3
E,1,19429,35,f,60,25
E,1,19489,71, ,64,-7
E,1,19553,63,t,55,-8
E,1,19608,73,h,93,20
E,1,19701,73,e,37,-36
E,1,19738,84, ,195,111
E,1,19933,64,G,190,126
E,1,20123,68,a,69,1
E,1,20192,71,l,85,14
E,1,20277,81,a,845,764
E,1,21122,88,x,256,168
E,1,21378,72,y,56,-16
E,1,21434,85, ,84,-1
E,1,21518,56,l,161,105
E,1,21679,73,i,85,12
E,1,21764,68,e,150,82
E,1,21914,79,s,68,-11
E,1,21982,88, ,124,36
E,1,22106,93,a,162,69
E,1,22268,56, ,108,52
E,1,22376,85,s,111,26
E,1,22487,64,m,61,-3
E,1,22548,68,a,131,63
E,1,22679,69,l,139,70
E,1,22818,64,l,67,3
E,1,22885,77, ,128,51
E,1,23013,76,u,121,45
E,1,23134,76,n,65,-11
E,1,23199,72,r,48,-24
E,1,23247,112,e,136,24
E,1,23383,69,g,147,78
E,1,23530,120,a,56,-64
E,1,23586,76,r,175,99
E,1,23761,64,d,135,71
E,1,23896,73,e,80,7
E,1,23976,113,d,154,41
E,1,24130,92, ,95,3
E,1,24225,56,y,53,-3
E,1,24278,40,t,37,-3
E,1,24315,75,e,78,3
E,1,24393,53,l,696,643
E,1,25089,76,e,135,59
E,1,25224,61,l,131,70
E,1,25355,77,l,166,89
E,1,25521,83,o,76,-7
E,1,25597,103,w,64,-39
E,1,25661,116, ,130,14
E,1,25791,98,s,40,-58
E,1,25831,85,u,198,113
E,1,26029,72,n,401,329
E,1,26430,48,.,6762,6714
E,1,33192,64,O,152,88
E,1,33344,49,r,142,93
E,1,33486,53,b,67,14
E,1,33553,92,i,100,8
E,1,33653,57,t,111,54
E,1,33764,109,i,64,-45
E,1,33828,84,n,50,-34
E,1,33878,62,g,89,27
E,1,33967,76, ,72,-4
E,1,34039,57,t,107,50
E,1,34146,57,h,93,36
E,1,34239,84,i,68,-16
E,1,34307,76,s,88,12
E,1,34395,61, ,90,29
E,1,34485,126,a,100,-26
E,1,34585,108,t,52,-56
E,1,34637,76, ,160,84
E,1,34797,65, ,394,329
E,1,35191,54,d,72,18
E,1,35263,80,i,92,12
E,1,35355,41,s,141,100
E,1,35496,115,t,108,-7
E,1,35604,105,a,108,3
E,1,35712,89,n,107,18
E,1,35819,69,c,156,87
E,1,35975,89,e,3151,3062
E,1,39126,76, ,121,45
E,1,39247,115,a,92,-23
E,1,39339,64, ,149,85
E,1,39488,61,d,94,33
E,1,39582,79,i,72,-7
E,1,39654,53,s,137,84
E,1,39791,77,t,105,28
E,1,39896,77,a,104,27
E,1,40000,49,n,83,34
E,1,40083,53,c,144,91
E,1,40227,80,e,84,4
E,1,40311,66, ,79,13
E,1,40390,76,o,64,-12
E,1,40454,53,f,78,25
E,1,40532,56, ,71,15
E,1,40603,60,r,68,8
E,1,40671,73,o,169,96
E,1,40840,80,u,48,-32
E,1,40888,76,g,97,21
E,1,40985,61,h,128,67
E,1,41113,69,l,72,3
E,1,41185,85,y,101,16
E,1,41286,96, ,239,143
E,1,41525,68,n,662,594
E,1,42187,124,i,84,-40
E,1,42271,100,n,128,28
E,1,42399,77,e,311,234
E,1,42710,57,t,138,81
E,1,42848,61,y,422,361
E,1,43270,92,t,80,-12
E,1,43350,99,w,88,-11
E,1,43438,81,o,200,119
E,1,43638,64, ,126,62
E,1,43764,57,m,227,170
E,1,43991,92,i,226,134
E,1,44217,49,l,128,79
E,1,44345,73,l,190,117
E,1,44535,48,i,152,104
E,1,44687,68,o,64,-4
E,1,44751,48,n,158,110
E,1,44909,48, ,52,4
E,1,44961,68,m,180,112
E,1,45141,85,i,203,118
E,1,45344,69,l,97,28
E,1,45441,77,e,168,91
E,1,45609,77,s,174,97
E,1,45783,68, ,130,62
E,1,45913,72,i,48,-24
E,1,45961,76,s,88,12
E,1,46049,97, ,117,20
E,1,46166,68,a,100,32
E,1,46266,69,n,96,27
E,1,46362,76, ,186,110
E,1,46548,92,u,104,12
E,1,46652,60,t,122,62
E,1,46774,61,t,119,58
E,1,46893,91,e,60,-31
E,1,46953,72,r,104,32
E,1,47057,76,l,88,12
E,1,47145,80,y,81,1
E,1,47226,84, ,109,25
E,1,47335,72,i,211,139
E,1,47546,56,n,112,56
E,1,47658,57,s,99,42
E,1,47757,69,i,118,49
E,1,47875,61,g,128,67
E,1,48003,60,n,147,87
E,1,48150,76,i,139,63
E,1,48289,57,f,108,51
E,1,48397,80,i,60,-20
E,1,48457,56,c,140,84
E,1,48597,71,a,68,-3
E,1,48665,64,n,124,60
E,1,48789,71,t,56,-15
E,1,48845,94, ,56,-38
E,1,48901,68,l,151,83
E,1,49052,92,i,68,-24
E,1,49120,52,t,106,54
E,1,49226,60,t,99,39
E,1,49325,76,l,95,19
E,1,49420,100,e,80,-20
E,1,49500,60, ,145,85
E,1,49645,68,b,69,1
E,1,49714,63,l,164,101
E,1,49878,99,u,88,-11
E,1,49966,83,e,44,-39
E,1,50010,63, ,108,45
E,1,50118,76,g,190,114
E,1,50308,104,r,80,-24
E,1,50388,88,e,166,78
E,1,50554,60,e,88,28
E,1,50642,76,n,91,15
E,1,50733,81, ,102,21
E,1,50835,96,p,68,-28
E,1,50903,88,l,105,17
E,1,51008,77,a,112,35
E,1,51120,72,n,112,40
E,1,51232,40,e,114,74
E,1,51346,89,t,73,-16
E,1,51419,84, ,87,3
E,1,51506,77,w,138,61
E,1,51644,80,h,103,23
E,1,51747,72,o,93,21
E,1,51840,76,s,132,56
E,1,51972,63,e,36,-27
E,1,52008,80, ,56,-24
E,1,52064,91,a,84,-7
E,1,52148,80,p,110,30
E,1,52258,76,e,244,168
E,1,52502,60,d,112,52
E,1,52614,80,e,132,52
E,1,52746,113,s,97,-16
E,1,52843,52,c,141,89
E,1,52984,64,e,72,8
E,1,53056,72,n,98,26
E,1,53154,52,d,126,74
E,1,53280,105,e,147,42
E,1,53427,60,d,109,49
E,1,53536,81, ,99,18
E,1,53635,65,l,176,111
E,1,53811,50,i,66,16
E,1,53877,107,f,96,-11
E,1,53973,88,e,143,55
E,1,54116,76, ,134,58
E,1,54250,69,f,88,19
E,1,54338,93,o,105,12
E,1,54443,68,r,110,42
E,1,54553,65,m,112,47
E,1,54665,88,s,775,687
E,1,55440,67, ,234,167
E,1,55674,124,a,135,11
E,1,55809,113,r,85,-28
E,1,55894,120,e,64,-56
E,1,55958,80, ,135,55
E,1,56093,88,s,85,-3
E,1,56178,76,o,1,-75
E,1,56179,110, ,114,4
E,1,56293,86,a,113,27
E,1,56406,76,m,65,-11
E,1,56471,88,a,152,64
E,1,56623,100,z,135,35
E,1,56758,87,i,52,-35
E,1,56810,84,n,60,-24
E,1,56870,64,g,150,86
E,1,57020,57,l,64,7
E,1,57084,88,y,69,-19
E,1,57153,88, ,121,33
E,1,57274,81,p,102,21
E,1,57376,69,r,99,30
E,1,57475,89,i,189,100
E,1,57664,56,m,163,107
E,1,57827,64,i,79,15
E,1,57906,69,t,141,72
E,1,58047,72,i,61,-11
E,1,58108,53,v,124,71
E,1,58232,81,e,84,3
E,1,58316,93, ,57,-36
E,1,58373,71,t,55,-16
E,1,58428,80,h,77,-3
E,1,58505,79,a,60,-19
E,1,58565,52,t,66,14
E,1,58631,92, ,68,-24
E,1,58699,49,t,57,8
E,1,58756,72,h,99,27
E,1,58855,60,e,142,82
E,1,58997,88,y,155,67
E,1,59152,123, ,96,-27
E,1,59248,72,s,126,54
E,1,59374,65,t,44,-21
E,1,59418,73,i,187,114
E,1,59605,45,l,125,80
E,1,59730,76,l,61,-15
E,1,59791,87, ,52,-35
E,1,59843,72,t,135,63
E,1,59978,69,h,69,0
E,1,60047,72,i,92,20
E,1,60139,69,n,102,33
E,1,60241,69,k,100,31
E,1,60341,81, ,157,76
E,1,60498,53,d,81,28
E,1,60579,81,i,114,33
E,1,60693,81,g,121,40
E,1,60814,89,i,247,158
E,1,61061,85,t,92,7
E,1,61153,101,a,104,3
E,1,61257,89,l,128,39
E,1,61385,77, ,169,92
E,1,61554,140,w,97,-43
E,1,61651,110,a,87,-23
E,1,61738,65,t,169,104
E,1,61907,61,c,76,15
E,1,61983,72,h,84,12
E,1,62067,97,e,128,31
E,1,62195,93,s,100,7
E,1,62295,92, ,80,-12
E,1,62375,120,a,96,-24
E,1,62471,120,r,68,-52
E,1,62539,145,e,88,-57
E,1,62627,69, ,107,38
E,1,62734,105,a,273,168
E,1,63007,81, ,119,38
E,1,63126,68,p,64,-4
E,1,63190,108,r,68,-40
E,1,63258,80,e,138,58
E,1,63396,61,t,119,58
E,1,63515,65,t,128,63
E,1,63643,68,y,65,-3
E,1,63708,72, ,115,43
E,1,63823,72,n,48,-24
E,1,63871,128,e,108,-20
E,1,63979,125,a,237,112
E,1,64216,85,t,104,19
E,1,64320,77, ,120,43
E,1,64440,80,i,65,-15
E,1,64505,52,d,129,77
E,1,64634,72,e,45,-27
E,1,64679,95,a,99,4
E,1,64778,53,.,726,673
E,1,65504,60,T,196,136
E,1,65700,69,h,116,47
E,1,65816,76,i,80,4
E,1,65896,80,s,40,-40
E,1,65936,85, ,122,37
E,1,66058,124,p,108,-16
E,1,66166,88,l,72,-16
E,1,66238,144,a,72,-72
E,1,66310,80,t,279,199
E,1,66589,80,e,759,679
E,1,67348,74,n,40,-34
E,1,67388,84,e,99,15
E,1,67487,85,t,129,44
E,1,67616,85, ,150,65
E,1,67766,84,h,64,-20
E,1,67830,117,a,56,-61
E,1,67886,84,s,151,67
E,1,68037,57,",",86,29
E,1,68123,65, ,112,47
E,1,68235,57,o,57,0
E,1,68292,63,r,71,8
E,1,68363,93, ,92,-1
E,1,68455,23,t,401,378
E,1,68856,65,r,144,79
E,1,69000,116,a,76,-40
E,1,69076,64,t,173,109
E,1,69249,64,h,111,47
E,1,69360,100,e,76,-24
E,1,69436,73,r,132,59
E,1,69568,80, ,108,28
E,1,69676,80,h,64,-16
E,1,69740,148,a,76,-72
E,1,69816,100,d,139,39
E,1,69955,69,",",68,-1
E,1,70023,89, ,103,14
E,1,70126,100,a,104,4
E,1,70230,64, ,52,-12
E,1,70282,56,p,93,37
E,1,70375,64,r,78,14
E,1,70453,65,o,85,20
E,1,70538,61,b,100,39
E,1,70638,61,l,87,26
E,1,70725,57,e,79,22
E,1,70804,68,m,183,115
E,1,70987,72,",",80,8
E,1,71067,68, ,20,-48
E,1,71087,72,w,119,47
E,1,71206,69,h,186,117
E,1,71392,52,c,1294,1242
E,1,72686,77,h,109,32
E,1,72795,69,i,85,16
E,1,72880,65,c,103,38
E,1,72983,72,h,110,38
E,1,73093,73, ,102,29
E,1,73195,112,w,187,75
E,1,73382,96,s,180,84
E,1,73562,84, ,100,16
E,1,73662,61,t,115,54
E,1,73777,61,h,85,24
E,1,73862,76,i,64,-12
E,1,73926,85,s,238,153
E,1,74164,52,:,1228,1176
E,1,75392,120,a,80,-40
E,1,75472,112,s,115,3
E,1,75587,110, ,136,26
E,1,75723,56,t,98,42
E,1,75821,81,h,95,14
E,1,75916,81,i,81,0
E,1,75997,75,s,245,170
E,1,76242,52,:,214,162
E,1,76456,69, ,164,95
E,1,76620,60,m,157,97
E,1,76777,76,o,60,-16
E,1,76837,64,s,152,88
E,1,76989,87,t,84,-3
E,1,77073,68, ,128,60
E,1,77201,72,o,80,8
E,1,77281,32,f,75,43
E,1,77356,92, ,72,-20
E,1,77428,60,t,44,-16
E,1,77472,60,h,120,60
E,1,77592,69,e,37,-32
E,1,77629,91, ,64,-27
E,1,77693,75,p,167,92
E,1,77860,69,o,395,326
E,1,78255,84,e,132,48
E,1,78387,56,o,178,122
E,1,78565,96,p,52,-44
E,1,78617,84,l,64,-20
E,1,78681,75,e,68,-7
E,1,78749,80, ,110,30
E,1,78859,128,o,88,-40
E,1,78947,80,n,100,20
E,1,79047,75, ,130,55
E,1,79177,80,i,81,1
E,1,79258,68,t,63,-5
E,1,79321,72, ,90,18
E,1,79411,136,w,100,-36
E,1,79511,76,e,52,-24
E,1,79563,124,r,84,-40
E,1,79647,112,e,72,-40
E,1,79719,76, ,223,147
E,1,79942,72,u,159,87
E,1,80101,72,n,96,24
E,1,80197,91,h,70,-21
E,1,80267,88,a,80,-8
E,1,80347,66,p,158,92
E,1,80505,72,p,84,12
E,1,80589,87,y,80,-7
E,1,80669,76, ,176,100
E,1,80845,60,f,67,7
E,1,80912,69,o,104,35
E,1,81016,51,r,32,-19
E,1,81048,97, ,97,0
E,1,81145,84,p,71,-13
E,1,81216,96,r,60,-36
E,1,81276,108,e,186,78
E,1,81462,64,t,127,63
E,1,81589,56,t,152,96
E,1,81741,77,y,81,4
E,1,81822,68, ,75,7
E,1,81897,69,m,169,100
E,1,82066,80,u,92,12
E,1,82158,39,c,107,68
E,1,82265,60,h,92,32
E,1,82357,68, ,153,85
E,1,82510,67,o,56,-11
E,1,82566,25,f,57,32
E,1,82623,91, ,75,-16
E,1,82698,67,t,56,-11
E,1,82754,80,h,92,12
E,1,82846,80,e,60,-20
E,1,82906,88, ,68,-20
E,1,82974,92,t,44,-48
E,1,83018,76,i,162,86
E,1,83180,71,m,64,-7
E,1,83244,85,e,139,54
E,1,83383,57,.,79,22
E,1,83462,72, ,189,117
E,1,83651,60,M,149,89
E,1,83800,63,a,47,-16
E,1,83847,49,n,152,103
E,1,83999,72,y,52,-20
E,1,84051,84, ,163,79
E,1,84214,84,s,88,4
E,1,84302,48,u,444,396
E,1,84746,69,o,153,84
E,1,84899,53,l,148,95
E,1,85047,88,u,100,12
E,1,85147,56,t,405,349
E,1,85552,86,i,202,116
E,1,85754,72,o,80,8
E,1,85834,51,n,162,111
E,1,85996,72,s,81,9
E,1,86077,122, ,103,-19
E,1,86180,131,w,88,-43
E,1,86268,91,e,55,-36
E,1,86323,122,r,88,-34
E,1,86411,117,e,93,-24
E,1,86504,60, ,107,47
E,1,86611,93,s,159,66
E,1,86770,81,u,80,-1
E,1,86850,48,g,104,56
E,1,86954,70,g,115,45
E,1,87069,135,e,143,8
E,1,87212,113,s,173,60
E,1,87385,106,t,116,10
E,1,87501,90,e,89,-1
E,1,87590,84,d,165,81
E,1,87755,65, ,160,95
E,1,87915,80,f,87,7
E,1,88002,49,o,73,24
E,1,88075,57,r,59,2
E,1,88134,109, ,93,-16
E,1,88227,64,t,108,44
E,1,88335,77,h,80,3
E,1,88415,77,i,98,21
E,1,88513,83,s,48,-35
E,1,88561,88, ,95,7
E,1,88656,69,p,53,-16
E,1,88709,60,r,136,76
E,1,88845,84,o,33,-51
E,1,88878,87,b,188,101
E,1,89066,80,l,125,45
E,1,89191,74,e,95,21
E,1,89286,61,m,342,281
E,1,89628,72,",",259,187
E,1,89887,72, ,154,82
E,1,90041,52,b,53,1
E,1,90094,75,u,110,35
E,1,90204,87,t,64,-23
E,1,90268,84, ,114,30
E,1,90382,33,m,111,78
E,1,90493,89,o,37,-52
E,1,90530,72,s,118,46
E,1,90648,83,t,56,-27
E,1,90704,64, ,87,23
E,1,90791,96,o,65,-31
E,1,90856,56,f,77,21
E,1,90933,69, ,83,14
E,1,91016,61,t,98,37
E,1,91114,72,h,163,91
E,1,91277,76,e,108,32
E,1,91385,90,s,141,51
E,1,91526,77,e,94,17
E,1,91620,78, ,77,-1
E,1,91697,114,w,63,-51
E,1,91760,100,e,68,-32
E,1,91828,137,r,81,-56
E,1,91909,120,e,83,-37
E,1,91992,65, ,473,408
E,1,92465,93,l,81,-12
E,1,92546,94,a,55,-39
E,1,92601,76,r,171,95
E,1,92772,64,g,113,49
E,1,92885,81,e,106,25
E,1,92991,103,l,73,-30
E,1,93064,84,y,87,3
E,1,93151,75, ,148,73
E,1,93299,36,c,40,4
E,1,93339,132,o,65,-67
E,1,93404,93,n,39,-54
E,1,93443,53,c,151,98
E,1,93594,93,e,81,-12
E,1,93675,67,r,64,-3
E,1,93739,71,n,64,-7
E,1,93803,92,e,106,14
E,1,93909,73,d,76,3
E,1,93985,101, ,53,-48
E,1,94038,88,w,132,44
E,1,94170,96,i,12,-84
E,1,94182,69,t,117,48
E,1,94299,77,h,126,49
E,1,94425,96, ,52,-44
E,1,94477,68,t,72,4
E,1,94549,76,h,68,-8
E,1,94617,96,e,64,-32
E,1,94681,93, ,136,43
E,1,94817,29,m,127,98
E,1,94944,112,o,44,-68
E,1,94988,51,v,131,80
E,1,95119,69,e,80,11
E,1,95199,57,m,76,19
E,1,95275,69,e,92,23
E,1,95367,77,n,84,7
E,1,95451,65,t,231,166
E,1,95682,80,s,199,119
E,1,95881,57, ,130,73
E,1,96011,65,o,65,0
E,1,96076,68,f,76,8
E,1,96152,63, ,78,15
E,1,96230,112,s,72,-40
E,1,96302,53,m,132,79
E,1,96434,80,a,61,-19
E,1,96495,60,l,156,96
E,1,96651,68,l,400,332
E,1,97051,68, ,293,225
E,1,97344,24,s,292,268
E,1,97636,60,g,165,105
E,1,97801,109,r,68,-41
E,1,97869,81,e,154,73
E,1,98023,68,e,76,8
E,1,98099,65,n,122,57
E,1,98221,81, ,134,53
E,1,98355,77,p,168,91
E,1,98523,112,i,48,-64
E,1,98571,87,e,128,41
E,1,98699,77,c,164,87
E,1,98863,104,e,133,29
E,1,98996,97,s,76,-21
E,1,99072,81, ,99,18
E,1,99171,64,o,56,-8
E,1,99227,73,f,74,1
E,1,99301,59, ,76,17
E,1,99377,87,p,52,-35
E,1,99429,85,a,135,50
E,1,99564,84,p,77,-7
E,1,99641,95,e,68,-27
E,1,99709,96,r,164,68
E,1,99873,57,",",81,24
E,1,99954,100, ,76,-24
E,1,100030,96,w,139,43
E,1,100169,60,h,81,21
E,1,100250,73,i,91,18
E,1,100341,56,c,105,49
E,1,100446,76,h,68,-8
E,1,100514,57, ,118,61
E,1,100632,74,i,41,-33
E,1,100673,87,s,67,-20
E,1,100740,69, ,116,47
E,1,100856,101,o,57,-44
E,1,100913,55,d,126,71
E,1,101039,61,d,109,48
E,1,101148,89, ,176,87
E,1,101324,76,b,37,-39
E,1,101361,115,e,134,19
E,1,101495,100,c,76,-24
E,1,101571,76,a,52,-24
E,1,101623,92,u,100,8
E,1,101723,88,s,96,8
E,1,101819,108,e,88,-20
E,1,101907,88, ,84,-4
E,1,101991,113,o,127,14
E,1,102118,68,n,32,-36
E,1,102150,109, ,137,28
E,1,102287,74,t,32,-42
E,1,102319,80,h,116,36
E,1,102435,84,e,60,-24
E,1,102495,116, ,76,-40
E,1,102571,112,w,156,44
E,1,102727,60,h,72,12
E,1,102799,53,i,208,155
E,1,103007,85,l,96,11
E,1,103103,93,e,69,-24
E,1,103172,92, ,924,832
E,1,104096,85,o,167,82
E,1,104263,66,l,65,-1
E,1,104328,95,e,52,-43
E,1,104380,87, ,99,12
E,1,104479,77,i,120,43
E,1,104599,84,t,64,-20
E,1,104663,104, ,72,-32
E,1,104735,120,w,52,-68
E,1,104787,156,a,112,-44
E,1,104899,104,s,72,-32
E,1,104971,72,n,174,102
E,1,105145,85,',102,17
E,1,105247,51,t,47,-4
E,1,105294,109, ,77,-32
E,1,105371,68,t,126,58
E,1,105497,72,h,150,78
E,1,105647,93,e,68,-25
E,1,105715,100, ,105,5
E,1,105820,84,s,83,-1
E,1,105903,65,m,87,22
E,1,105990,81,a,102,21
E,1,106092,53,l,136,83
E,1,106228,76,l,32,-44
E,1,106260,89, ,106,17
E,1,106366,85,g,189,104
E,1,106555,108,r,96,-12
E,1,106651,60,e,133,73
E,1,106784,69,e,98,29
E,1,106882,60,n,68,8
E,1,106950,81, ,123,42
E,1,107073,73,p,178,105
E,1,107251,76,i,80,4
E,1,107331,68,e,145,77
E,1,107476,69,c,167,98
E,1,107643,80,e,161,81
E,1,107804,88,s,76,-12
E,1,107880,81, ,124,43
E,1,108004,69,o,68,-1
E,1,108072,60,f,64,4
E,1,108136,65, ,111,46
E,1,108247,64,p,72,8
E,1,108319,69,a,109,40
E,1,108428,64,p,68,4
E,1,108496,108,e,88,-20
E,1,108584,80,r,68,-12
E,1,108652,109, ,76,-33
E,1,108728,72,t,68,-4
E,1,108796,68,h,57,-11
E,1,108853,103,a,83,-20
E,1,108936,79,t,76,-3
E,1,109012,108, ,44,-64
E,1,109056,140,a,177,37
E,1,109233,153,e,364,211
E,1,109597,124,w,84,-40
E,1,109681,60,e,36,-24
E,1,109717,128,r,104,-24
E,1,109821,104,e,885,781
E,1,110706,144,w,96,-48
E,1,110802,76,e,40,-36
E,1,110842,120,r,88,-32
E,1,110930,92,e,88,-4
E,1,111018,60, ,142,82
E,1,111160,52,u,128,76
E,1,111288,56,n,64,8
E,1,111352,88,h,64,-24
E,1,111416,88,a,89,1
E,1,111505,39,p,116,77
E,1,111621,64,p,39,-25
E,1,111660,57,y,155,98
E,1,111815,64,.,NA,NA
E,2,127,73,M,199,126
E,2,326,81,y,102,21
E,2,428,69, ,142,73
E,2,570,60,f,72,12
E,2,642,100,a,101,1
E,2,743,68,v,181,113
E,2,924,73,o,94,21
E,2,1018,57,r,112,55
E,2,1130,70,i,32,-38
E,2,1162,64,t,153,89
E,2,1315,144,e,124,-20
E,2,1439,93, ,132,39
E,2,1571,68,f,90,22
E,2,1661,52,o,147,95
E,2,1808,81,o,8,-73
E,2,1816,73,d,3574,3501
E,2,5390,84,O,211,127
E,2,5601,77,n,76,-1
E,2,5677,75,e,72,-3
E,2,5749,72, ,40,-32
E,2,5789,88,o,103,15
E,2,5892,60,f,68,8
E,2,5960,52, ,59,7
E,2,6019,65,m,66,1
E,2,6085,103,y,83,-20
E,2,6168,85, ,382,297
E,2,6550,99,f,96,-3
E,2,6646,120,a,96,-24
E,2,6742,73,v,101,28
E,2,6843,72,i,159,87
E,2,7002,76,o,48,-28
E,2,7050,68,r,147,79
E,2,7197,76,t,927,851
E,2,8124,80,o,68,-12
E,2,8192,52,r,111,59
E,2,8303,68,i,24,-44
E,2,8327,60,t,112,52
E,2,8439,124,e,76,-48
E,2,8515,96, ,104,8
E,2,8619,77,f,96,19
E,2,8715,64,o,129,65
E,2,8844,92,o,16,-76
E,2,8860,144,d,79,-65
E,2,8939,121,s,212,91
E,2,9151,73, ,72,-1
E,2,9223,64,i,119,55
E,2,9342,76,s,282,206
E,2,9624,64, ,110001,109937
E,2,119625,63,M,206,143
E,2,119831,80,y,118,38
E,2,119949,45, ,113,68
E,2,120062,64,f,411,347
E,2,120473,132,a,159,27
E,2,120632,57,v,83,26
E,2,120715,72,o,107,35
E,2,120822,53,r,84,31
E,2,120906,72,i,57,-15
E,2,120963,60,t,110,50
E,2,121073,117,e,110,-7
E,2,121183,75, ,152,77
E,2,121335,61,f,96,35
E,2,121431,65,o,142,77
E,2,121573,76,o,24,-52
E,2,121597,72,d,203,131
E,2,121800,57, ,1817,1760
E,2,123617,92,O,202,110
E,2,123819,72,n,68,-4
E,2,123887,88,e,77,-11
E,2,123964,71, ,55,-16
E,2,124019,100,o,96,-4
E,2,124115,88,f,100,12
E,2,124215,48, ,60,12
E,2,124275,64,m,76,12
E,2,124351,76,y,64,-12
E,2,124415,77, ,115,38
E,2,124530,72,f,110,38
E,2,124640,112,a,64,-48
E,2,124704,81,v,650,569
E,2,125354,39,o,43,4
E,2,125397,57,r,109,52
E,2,125506,68,i,45,-23
E,2,125551,39,t,148,109
E,2,125699,61,e,40,-21
E,2,125739,80, ,120,40
E,2,125859,85,f,121,36
E,2,125980,57,o,131,74
E,2,126111,64,o,26,-38
E,2,126137,106,d,39,-67
E,2,126176,111,s,192,81
E,2,126368,56, ,60,4
E,2,126428,73,i,122,49
E,2,126550,69,s,277,208
E,2,126827,81, ,8555,8474
E,2,135382,62,n,169,107
E,2,135551,72,o,167,95
E,2,135718,80,o,536,456
E,2,136254,66,d,110,44
E,2,136364,84,l,73,-11
E,2,136437,56,e,126,70
E,2,136563,72,s,69,-3
E,2,136632,84,.,144,60
E,2,136776,64, ,255,191
E,2,137031,60,I,198,138
E,2,137229,72, ,134,62
E,2,137363,52,d,73,21
E,2,137436,149,o,85,-64
E,2,137521,48,n,6116,6068
E,2,143637,68,I,401,333
E,2,144038,73, ,326,253
E,2,144364,61,l,152,91
E,2,144516,57,i,142,85
E,2,144658,96,k,85,-11
E,2,144743,107,e,662,555
E,2,145405,61, ,127,66
E,2,145532,76,a,60,-16
E,2,145592,73,n,142,69
E,2,145734,62,y,145,83
E,2,145879,69,t,9121,9052
E,2,155000,80,I,301,221
E,2,155301,80, ,3912,3832
E,2,159213,100,I,297,197
E,2,159510,100, ,104,4
E,2,159614,88,e,117,29
E,2,159731,60,n,164,104
E,2,159895,53,j,150,97
E,2,160045,75,o,72,-3
E,2,160117,37,y,935,898
E,2,161052,109, ,317,208
E,2,161369,96,p,103,7
E,2,161472,105,a,53,-52
E,2,161525,100,s,237,137
E,2,161762,89,t,173,84
E,2,161935,92,a,141,49
E,2,162076,129, ,128,-1
E,2,162204,139,a,109,-30
E,2,162313,78,s,67,-11
E,2,162380,127, ,104,-23
E,2,162484,120,w,68,-52
E,2,162552,111,e,112,1
E,2,162664,60,l,146,86
E,2,162810,90,l,45,-45
E,2,162855,108, ,96,-12
E,2,162951,132,a,64,-68
E,2,163015,132,s,212,80
E,2,163227,80, ,338,258
E,2,163565,103,r,76,-27
E,2,163641,79,a,56,-23
E,2,163697,60,m,97,37
E,2,163794,89,e,69,-20
E,2,163863,76,n,77,1
E,2,163940,139, ,75,-64
E,2,164015,120,a,71,-49
E,2,164086,77,n,115,38
E,2,164201,88,d,95,7
E,2,164296,65, ,135,70
E,2,164431,55,p,48,-7
E,2,164479,81,h,119,38
E,2,164598,88,o,263,175
E,2,164861,97,",",161,64
E,2,165022,56, ,3560,3504
E,2,168582,72,;,158,86
E,2,168740,77, ,224,147
E,2,168964,112,r,64,-48
E,2,169028,132,e,95,-37
E,2,169123,56,a,12,-44
E,2,169135,66,l,171,105
E,2,169306,53,l,65,12
E,2,169371,96,y,146,50
E,2,169517,97, ,363,266
E,2,169880,92,a,99,7
E,2,169979,73,n,138,65
E,2,170117,76,y,257,181
E,2,170374,72, ,149,77
E,2,170523,116,o,710,594
E,2,171233,72,t,141,69
E,2,171374,61,y,91,30
E,2,171465,77,p,103,26
E,2,171568,85,e,65,-20
E,2,171633,71, ,63,-8
E,2,171696,77,o,76,-1
E,2,171772,84,f,76,-8
E,2,171848,65, ,265,200
E,2,172113,72,n,187,115
E,2,172300,52,o,131,79
E,2,172431,89,o,96,7
E,2,172527,53,d,111,58
E,2,172638,82,l,40,-42
E,2,172678,81,e,142,61
E,2,172820,110,s,203,93
E,2,173023,80, ,2290,2210
E,2,175313,108,I,1383,1275
E,2,176696,128, ,2650,2522
E,2,179346,125,w,128,3
E,2,179474,89,i,207,118
E,2,179681,49,l,136,87
E,2,179817,72,l,75,3
E,2,179892,140, ,84,-56
E,2,179976,112,a,128,16
E,2,180104,83,l,64,-19
E,2,180168,139,w,59,-80
E,2,180227,131,a,124,-7
E,2,180351,97,y,129,32
E,2,180480,77,s,232,155
E,2,180712,72, ,127,55
E,2,180839,89,l,188,99
E,2,181027,69,i,163,94
E,2,181190,57,k,76,19
E,2,181266,45,e,129,84
E,2,181395,77,.,110,33
E,2,181505,97, ,8754,8657
E,2,190259,84,",",319,235
E,2,190578,71, ,118,47
E,2,190696,100,s,81,-19
E,2,190777,67,o,651,584
E,2,191428,60, ,11763,11703
E,2,203191,60,U,149,89
E,2,203340,85,s,70,-15
E,2,203410,95,u,135,40
E,2,203545,42,a,83,41
E,2,203628,37,l,140,103
E,2,203768,53,l,67,14
E,2,203835,68,y,65,-3
E,2,203900,115, ,100,-15
E,2,204000,40,t,61,21
E,2,204061,72,h,74,2
E,2,204135,40,e,120,80
E,2,204255,87,y,72,-15
E,2,204327,88, ,106,18
E,2,204433,164,a,113,-51
E,2,204546,108,r,48,-60
E,2,204594,132,e,63,-69
E,2,204657,101, ,172,71
E,2,204829,72,b,53,-19
E,2,204882,64,e,102,38
E,2,204984,80,t,135,55
E,2,205119,100,t,154,54
E,2,205273,129,e,94,-35
E,2,205367,99,r,365,266
E,2,205732,96, ,2606,2510
E,2,208338,69,h,130,61
E,2,208468,57,o,2987,2930
E,2,211455,52,r,594,542
E,2,212049,77,t,913,836
E,2,212962,44,t,36,-8
E,2,212998,85, ,634,549
E,2,213632,55,o,68,13
E,2,213700,65,t,60,-5
E,2,213760,69, ,98,29
E,2,213858,76,a,69,-7
E,2,213927,43,n,51,8
E,2,213978,116,d,96,-20
E,2,214074,89, ,130,41
E,2,214204,40,i,21,-19
E,2,214225,80,n,55,-25
E,2,214280,81, ,125,44
E,2,214405,65,s,100,35
E,2,214505,85,o,144,59
E,2,214649,57,u,88,31
E,2,214737,73,p,167,94
E,2,214904,72, ,477,405
E,2,215381,127,a,104,-23
E,2,215485,83,s,84,1
E,2,215569,135, ,79,-56
E,2,215648,111,w,64,-47
E,2,215712,89,e,44,-45
E,2,215756,64,l,130,66
E,2,215886,77,l,194,117
E,2,216080,57,.,NA,NA
F,1,155,126,F,189,63
F,1,344,156,a,77,-79
F,1,421,157,r,109,-48
F,1,530,141, ,141,0
F,1,671,142,o,62,-80
F,1,733,125,u,94,-31
F,1,827,173,t,110,-63
F,1,937,125, ,46,-79
F,1,983,188,i,142,-46
F,1,1125,124,n,46,-78
F,1,1171,172, ,126,-46
F,1,1297,124,t,78,-46
F,1,1375,140,h,93,-47
F,1,1468,173,e,62,-111
F,1,1530,157, ,422,265
F,1,1952,94,u,204,110
F,1,2156,93,n,78,-15
F,1,2234,93,c,125,32
F,1,2359,94,h,94,0
F,1,2453,125,a,47,-78
F,1,2500,108,r,234,126
F,1,2734,94,t,141,47
F,1,2875,108,e,218,110
F,1,3093,126,d,94,-32
F,1,3187,110, ,235,125
F,1,3422,108,b,171,63
F,1,3593,157,a,140,-17
F,1,3733,95,c,95,0
F,1,3828,110,k,124,14
F,1,3952,141,w,156,15
F,1,4108,158,a,141,-17
F,1,4249,125,t,172,47
F,1,4421,141,e,47,-94
F,1,4468,173,r,156,-17
F,1,4624,157,s,110,-47
F,1,4734,125, ,109,-16
F,1,4843,94,o,62,-32
F,1,4905,111,f,79,-32
F,1,4984,94, ,172,78
F,1,5156,140,t,78,-62
F,1,5234,124,h,62,-62
F,1,5296,204,e,95,-109
F,1,5391,140, ,125,-15
F,1,5516,93,u,171,78
F,1,5687,110,n,47,-63
F,1,5734,124,f,218,94
F,1,5952,220,a,126,-94
F,1,6078,140,s,125,-15
F,1,6203,156,h,78,-78
F,1,6281,202,i,140,-62
F,1,6421,157,o,125,-32
F,1,6546,110,n,95,-15
F,1,6641,186,a,139,-47
F,1,6780,125,b,94,-31
F,1,6874,141,l,94,-47
F,1,6968,172,e,125,-47
F,1,7093,156, ,125,-31
F,1,7218,125,e,94,-31
F,1,7312,140,n,109,-31
F,1,7421,156,d,62,-94
F,1,7483,125, ,157,32
F,1,7640,109,o,94,-15
F,1,7734,124,f,109,-15
F,1,7843,156, ,140,-16
F,1,7983,126,t,94,-32
F,1,8077,125,h,63,-62
F,1,8140,187,e,109,-78
F,1,8249,219, ,156,-63
F,1,8405,188,w,125,-63
F,1,8530,188,e,282,94
F,1,8812,156,s,125,-31
F,1,8937,125,t,156,31
F,1,9093,156,e,78,-78
F,1,9171,125,r,109,-16
F,1,9280,172,n,158,-14
F,1,9438,139, ,342,203
F,1,9780,125,s,110,-15
F,1,9890,125,p,250,125
F,1,10140,109,i,78,-31
F,1,10218,109,r,188,79
F,1,10406,124,a,109,-15
F,1,10515,110,l,110,0
F,1,10625,124, ,140,16
F,1,10765,140,a,93,-47
F,1,10858,125,r,63,-62
F,1,10921,172,m,187,15
F,1,11108,110, ,125,15
F,1,11233,125,o,79,-46
F,1,11312,109,f,109,0
F,1,11421,125, ,141,16
F,1,11562,78,t,46,-32
F,1,11608,141,h,63,-78
F,1,11671,172,e,95,-77
F,1,11766,124, ,233,109
F,1,11999,94,G,172,78
F,1,12171,94,a,78,-16
F,1,12249,94,l,78,-16
F,1,12327,125,a,360,235
F,1,12687,126,x,109,-17
F,1,12796,141,y,125,-16
F,1,12921,156, ,126,-30
F,1,13047,140,l,171,31
F,1,13218,125,i,47,-78
F,1,13265,172,e,93,-79
F,1,13358,110,s,94,-16
F,1,13452,141, ,125,-16
F,1,13577,156,a,110,-46
F,1,13687,140, ,265,125
F,1,13952,110,s,125,15
F,1,14077,110,m,64,-46
F,1,14141,108,a,108,0
F,1,14249,94,l,141,47
F,1,14390,93,l,125,32
F,1,14515,109, ,156,47
F,1,14671,94,u,219,125
F,1,14890,109,n,125,16
F,1,15015,140,r,93,-47
F,1,15108,141,e,188,47
F,1,15296,94,g,109,15
F,1,15405,188,a,125,-63
F,1,15530,110,r,203,93
F,1,15733,94,d,157,63
F,1,15890,141,e,312,171
F,1,16202,125,d,125,0
F,1,16327,141, ,281,140
F,1,16608,172,y,141,-31
F,1,16749,156,e,0,-156
F,1,16749,78,l,484,406
F,1,17233,110,l,188,78
F,1,17421,125,o,78,-47
F,1,17499,141,w,94,-47
F,1,17593,156, ,203,47
F,1,17796,125,s,172,47
F,1,17968,94,u,188,94
F,1,18156,109,n,202,93
F,1,18358,94,.,111,17
F,1,18469,140, ,47671,47531
F,1,66140,140,O,375,235
F,1,66515,109,r,390,281
F,1,66905,141,b,141,0
F,1,67046,109,i,187,78
F,1,67233,141,t,172,31
F,1,67405,110,i,203,93
F,1,67608,141,n,141,0
F,1,67749,109,g,109,0
F,1,67858,172, ,204,32
F,1,68062,93,t,93,0
F,1,68155,157,h,63,-94
F,1,68218,172,i,78,-94
F,1,68296,109,s,94,-15
F,1,68390,125, ,125,0
F,1,68515,172,a,93,-79
F,1,68608,157,t,94,-63
F,1,68702,157, ,141,-16
F,1,68843,125,t,109,-16
F,1,68952,156,h,47,-109
F,1,68999,188,e,109,-79
F,1,69108,141, ,1219,1078
F,1,70327,141,a,156,15
F,1,70483,125, ,266,141
F,1,70749,94,d,47,-47
F,1,70796,109,i,125,16
F,1,70921,141,s,125,-16
F,1,71046,109,t,109,0
F,1,71155,78,n,16,-62
F,1,71171,141,a,828,687
F,1,71999,188,a,141,-47
F,1,72140,125,n,140,15
F,1,72280,125,c,188,63
F,1,72468,140,e,62,-78
F,1,72530,172, ,360,188
F,1,72890,125,o,62,-63
F,1,72952,156,f,63,-93
F,1,73015,172, ,359,187
F,1,73374,109,r,78,-31
F,1,73452,156,o,78,-78
F,1,73530,110,u,94,-16
F,1,73624,126,g,94,-32
F,1,73718,94,h,109,15
F,1,73827,156,l,125,-31
F,1,73952,156,y,47,-109
F,1,73999,172, ,125,-47
F,1,74124,126,n,203,77
F,1,74327,94,i,172,78
F,1,74499,141,n,109,-32
F,1,74608,141,e,219,78
F,1,74827,125,t,219,94
F,1,75046,125,y,734,609
F,1,75780,157,t,219,62
F,1,75999,141,w,109,-32
F,1,76108,141,o,94,-47
F,1,76202,156, ,156,0
F,1,76358,94,m,172,78
F,1,76530,125,i,219,94
F,1,76749,47,l,109,62
F,1,76858,94,l,204,110
F,1,77062,265,i,125,-140
F,1,77187,140,o,93,-47
F,1,77280,141,n,110,-31
F,1,77390,156, ,265,109
F,1,77655,110,m,172,62
F,1,77827,156,i,156,0
F,1,77983,188,e,0,-188
F,1,77983,157,l,125,-32
F,1,78108,157,s,142,-15
F,1,78250,187, ,1358,1171
F,1,79608,141,l,79,-62
F,1,79687,187,e,93,-94
F,1,79780,157,s,157,0
F,1,79937,140, ,218,78
F,1,80155,125,a,532,407
F,1,80687,125,i,62,-63
F,1,80749,94,s,109,15
F,1,80858,141, ,125,-16
F,1,80983,125,a,94,-31
F,1,81077,156,n,203,47
F,1,81280,125, ,250,125
F,1,81530,110,u,266,156
F,1,81796,94,n,359,265
F,1,82155,63,t,125,62
F,1,82280,78,t,157,79
F,1,82437,109,e,46,-63
F,1,82483,157,r,204,47
F,1,82687,140,l,218,78
F,1,82905,125,y,125,0
F,1,83030,172, ,157,-15
F,1,83187,172,i,78,-94
F,1,83265,140,n,78,-62
F,1,83343,125,s,156,31
F,1,83499,125,i,203,78
F,1,83702,94,f,688,594
F,1,84390,140,g,125,-15
F,1,84515,93,i,547,454
F,1,85062,93,n,125,32
F,1,85187,78,i,296,218
F,1,85483,110,f,282,172
F,1,85765,125,i,140,15
F,1,85905,110,c,188,78
F,1,86093,140,a,125,-15
F,1,86218,94,n,328,234
F,1,86546,172,t,125,-47
F,1,86671,156, ,453,297
F,1,87124,109,l,172,63
F,1,87296,109,i,47,-62
F,1,87343,78,t,140,62
F,1,87483,110,t,125,15
F,1,87608,125,l,94,-31
F,1,87702,172,e,125,-47
F,1,87827,126, ,235,109
F,1,88062,125,b,78,-47
F,1,88140,172,l,125,-47
F,1,88265,125,u,62,-63
F,1,88327,156,e,63,-93
F,1,88390,140, ,172,32
F,1,88562,109,g,234,125
F,1,88796,156,r,94,-62
F,1,88890,109,e,156,47
F,1,89046,141,e,78,-63
F,1,89124,125,n,47,-78
F,1,89171,172, ,172,0
F,1,89343,156,p,47,-109
F,1,89390,140,l,78,-62
F,1,89468,156,a,219,63
F,1,89687,109,n,250,141
F,1,89937,125,e,156,31
F,1,90093,156,t,62,-94
F,1,90155,172, ,188,16
F,1,90343,109,w,78,-31
F,1,90421,157,h,94,-63
F,1,90515,125,o,63,-62
F,1,90578,155,s,93,-62
F,1,90671,156,e,78,-78
F,1,90749,156, ,188,32
F,1,90937,125,a,187,62
F,1,91124,125,p,109,-16
F,1,91233,157,e,547,390
F,1,91780,32,c,469,437
F,1,92249,109,d,172,63
F,1,92421,125,e,141,16
F,1,92562,250,s,187,-63
F,1,92749,109,c,266,157
F,1,93015,140,e,62,-78
F,1,93077,219,n,235,16
F,1,93312,109,d,171,62
F,1,93483,141,e,172,31
F,1,93655,141,d,110,-31
F,1,93765,156, ,218,62
F,1,93983,110,l,157,47
F,1,94140,140,i,62,-78
F,1,94202,125,f,78,-47
F,1,94280,188,e,235,47
F,1,94515,109,f,609,500
F,1,95124,172, ,125,-47
F,1,95249,109,f,94,-15
F,1,95343,125,o,140,15
F,1,95483,110,r,157,47
F,1,95640,187,m,125,-62
F,1,95765,156,s,93,-63
F,1,95858,172, ,157,-15
F,1,96015,156,a,78,-78
F,1,96093,172,r,125,-47
F,1,96218,172,e,78,-94
F,1,96296,187, ,156,-31
F,1,96452,94,s,47,-47
F,1,96499,125,o,94,-31
F,1,96593,140, ,140,0
F,1,96733,94,a,94,0
F,1,96827,110,m,297,187
F,1,97124,125,a,219,94
F,1,97343,172,z,125,-47
F,1,97468,94,i,187,93
F,1,97655,125,n,63,-62
F,1,97718,140,g,187,47
F,1,97905,110,l,125,15
F,1,98030,157,y,94,-63
F,1,98124,156, ,234,78
F,1,98358,125,p,110,-15
F,1,98468,125,r,109,-16
F,1,98577,94,i,172,78
F,1,98749,63,m,172,109
F,1,98921,94,i,78,-16
F,1,98999,78,t,125,47
F,1,99124,94,i,203,109
F,1,99327,110,v,188,78
F,1,99515,156,e,78,-78
F,1,99593,203, ,140,-63
F,1,99733,110,t,110,0
F,1,99843,109,h,62,-47
F,1,99905,157,a,63,-94
F,1,99968,125,t,62,-63
F,1,100030,188, ,141,-47
F,1,100171,125,t,141,16
F,1,100312,109,h,78,-31
F,1,100390,140,e,140,0
F,1,100530,141,y,78,-63
F,1,100608,141, ,188,47
F,1,100796,172,s,78,-94
F,1,100874,157,t,94,-63
F,1,100968,95,i,126,31
F,1,101094,93,l,124,31
F,1,101218,94,l,78,-16
F,1,101296,141, ,78,-63
F,1,101374,125,t,78,-47
F,1,101452,141,h,63,-78
F,1,101515,125,i,140,15
F,1,101655,157,n,110,-47
F,1,101765,140,k,172,32
F,1,101937,125, ,265,140
F,1,102202,125,d,63,-62
F,1,102265,109,i,157,48
F,1,102422,108,g,77,-31
F,1,102499,109,i,156,47
F,1,102655,110,t,157,47
F,1,102812,125,a,62,-63
F,1,102874,141,l,156,15
F,1,103030,172, ,78,-94
F,1,103108,141,w,141,0
F,1,103249,141,a,156,15
F,1,103405,110,t,328,218
F,1,103733,110,c,110,0
F,1,103843,109,h,109,0
F,1,103952,172,e,110,-62
F,1,104062,109,s,109,0
F,1,104171,141, ,109,-32
F,1,104280,172,a,125,-47
F,1,104405,203,r,157,-46
F,1,104562,156,e,78,-78
F,1,104640,156, ,141,-15
F,1,104781,140,a,93,-47
F,1,104874,156, ,94,-62
F,1,104968,140,p,109,-31
F,1,105077,172,r,110,-62
F,1,105187,140,e,171,31
F,1,105358,125,t,173,48
F,1,105531,62,t,171,109
F,1,105702,156,y,78,-78
F,1,105780,141, ,188,47
F,1,105968,78,e,0,-78
F,1,105968,110,n,625,515
F,1,106593,125,e,172,47
F,1,106765,156,a,93,-63
F,1,106858,141,t,79,-62
F,1,106937,157, ,312,155
F,1,107249,141,i,234,93
F,1,107483,94,d,172,78
F,1,107655,157,e,110,-47
F,1,107765,140,a,187,47
F,1,107952,110,.,203,93
F,1,108155,141, ,2438,2297
F,1,110593,125,T,234,109
F,1,110827,141,h,47,-94
F,1,110874,142,i,64,-78
F,1,110938,124,s,45,-79
F,1,110983,158, ,110,-48
F,1,111093,140,p,109,-31
F,1,111202,110,l,78,-32
F,1,111280,125,a,125,0
F,1,111405,125,n,94,-31
F,1,111499,109,e,188,79
F,1,111687,156,s,93,-63
F,1,111780,157,t,141,-16
F,1,111921,109, ,969,860
F,1,112890,140,t,47,-93
F,1,112937,171, ,421,250
F,1,113358,158,h,79,-79
F,1,113437,171,a,93,-78
F,1,113530,141,s,219,78
F,1,113749,141,",",109,-32
F,1,113858,142, ,158,16
F,1,114016,124,o,62,-62
F,1,114078,140,r,77,-63
F,1,114155,141, ,282,141
F,1,114437,109,r,203,94
F,1,114640,156,a,93,-63
F,1,114733,141,t,94,-47
F,1,114827,141,h,111,-30
F,1,114938,186,e,61,-125
F,1,114999,188,r,78,-110
F,1,115077,156, ,125,-31
F,1,115202,110,h,78,-32
F,1,115280,141,a,219,78
F,1,115499,141,d,141,0
F,1,115640,109,",",109,0
F,1,115749,141, ,250,109
F,1,115999,156,a,94,-62
F,1,116093,188, ,265,77
F,1,116358,157,p,125,-32
F,1,116483,125,r,110,-15
F,1,116593,140,o,204,64
F,1,116797,124,b,108,-16
F,1,116905,125,l,110,-15
F,1,117015,140,e,125,-15
F,1,117140,140,m,359,219
F,1,117499,125, ,516,391
F,1,118015,140,",",140,0
F,1,118155,157, ,110,-47
F,1,118265,172,w,172,0
F,1,118437,125,h,78,-47
F,1,118515,93,i,109,16
F,1,118624,141,c,95,-46
F,1,118719,124,h,155,31
F,1,118874,188, ,78,-110
F,1,118952,142,w,142,0
F,1,119094,171,a,93,-78
F,1,119187,156,s,93,-63
F,1,119280,125, ,266,141
F,1,119546,94,t,62,-32
F,1,119608,157,h,110,-47
F,1,119718,140,i,109,-31
F,1,119827,110,s,266,156
F,1,120093,125,:,140,15
F,1,120233,157, ,188,31
F,1,120421,94,m,187,93
F,1,120608,110,o,79,-31
F,1,120687,156,s,109,-47
F,1,120796,141,t,94,-47
F,1,120890,156, ,156,0
F,1,121046,141,o,109,-32
F,1,121155,110,f,32,-78
F,1,121187,109, ,218,109
F,1,121405,110,t,78,-32
F,1,121483,94,h,79,-15
F,1,121562,140,e,62,-78
F,1,121624,156, ,78,-78
F,1,121702,125,p,94,-31
F,1,121796,125,e,94,-31
F,1,121890,93,o,62,-31
F,1,121952,172,p,110,-62
F,1,122062,125,l,46,-79
F,1,122108,157,e,79,-78
F,1,122187,156, ,140,-16
F,1,122327,156,i,531,375
F,1,122858,172,o,94,-78
F,1,122952,110,n,78,-32
F,1,123030,110, ,125,15
F,1,123155,172,i,110,-62
F,1,123265,125,t,47,-78
F,1,123312,171, ,140,-31
F,1,123452,172,w,110,-62
F,1,123562,156,e,110,-46
F,1,123672,171,r,93,-78
F,1,123765,187,e,109,-78
F,1,123874,125, ,125,0
F,1,123999,109,u,250,141
F,1,124249,94,n,203,109
F,1,124452,125,h,94,-31
F,1,124546,94,p,47,-47
F,1,124593,125,a,781,656
F,1,125374,141,a,109,-32
F,1,125483,79,p,125,46
F,1,125608,110,p,110,0
F,1,125718,156,y,94,-62
F,1,125812,156, ,250,94
F,1,126062,93,f,46,-47
F,1,126108,125,o,375,250
F,1,126483,173,r,94,-79
F,1,126577,172, ,156,-16
F,1,126733,157,p,110,-47
F,1,126843,172,r,109,-63
F,1,126952,125,e,188,63
F,1,127140,78,t,156,78
F,1,127296,47,t,141,94
F,1,127437,125,y,62,-63
F,1,127499,172, ,125,-47
F,1,127624,79,m,188,109
F,1,127812,78,u,125,47
F,1,127937,93,c,78,-15
F,1,128015,125,h,187,62
F,1,128202,156, ,1313,1157
F,1,129515,93,o,78,-15
F,1,129593,156,f,62,-94
F,1,129655,141, ,250,109
F,1,129905,79,t,0,-79
F,1,129905,47,y,47,0
F,1,129952,156,h,125,-31
F,1,130077,125,e,63,-62
F,1,130140,172, ,172,0
F,1,130312,125,t,93,-32
F,1,130405,110,i,188,78
F,1,130593,140,m,31,-109
F,1,130624,141,e,703,562
F,1,131327,156,.,156,0
F,1,131483,94, ,1672,1578
F,1,133155,141,h,78,-63
F,1,133233,125,e,250,125
F,1,133483,157, ,172,15
F,1,133655,141,t,125,-16
F,1,133780,110,i,219,109
F,1,133999,110,m,63,-47
F,1,134062,140,e,156,16
F,1,134218,140,.,4609,4469
F,1,138827,156, ,266,110
F,1,139093,125,M,219,94
F,1,139312,109,a,109,0
F,1,139421,125,n,156,31
F,1,139577,125,y,63,-62
F,1,139640,140, ,203,63
F,1,139843,140,s,125,-15
F,1,139968,125,o,156,31
F,1,140124,63,l,203,140
F,1,140327,94,u,63,-31
F,1,140390,93,t,141,48
F,1,140531,140,i,77,-63
F,1,140608,110,o,188,78
F,1,140796,109,n,266,157
F,1,141062,140,s,62,-78
F,1,141124,172, ,219,47
F,1,141343,140,w,94,-46
F,1,141437,140,e,93,-47
F,1,141530,157,r,94,-63
F,1,141624,156,e,94,-62
F,1,141718,173, ,125,-48
F,1,141843,125,s,78,-47
F,1,141921,125,u,125,0
F,1,142046,94,g,156,62
F,1,142202,78,g,110,32
F,1,142312,125,e,94,-31
F,1,142406,156,s,140,-16
F,1,142546,109,t,109,0
F,1,142655,110,e,219,109
F,1,142874,141,d,47,-94
F,1,142921,141, ,312,171
F,1,143233,110,f,125,15
F,1,143358,94,o,94,0
F,1,143452,125,r,63,-62
F,1,143515,172, ,140,-32
F,1,143655,110,t,63,-47
F,1,143718,156,h,47,-109
F,1,143765,125,i,62,-63
F,1,143827,125,s,47,-78
F,1,143874,156, ,94,-62
F,1,143968,125,p,125,0
F,1,144093,109,r,125,16
F,1,144218,140,o,187,47
F,1,144405,125,b,141,16
F,1,144546,125,l,203,78
F,1,144749,126,e,109,-17
F,1,144858,110,m,313,203
F,1,145171,141,",",94,-47
F,1,145265,78, ,156,78
F,1,145421,109,b,109,0
F,1,145530,125,u,141,16
F,1,145671,156,t,62,-94
F,1,145733,141, ,158,17
F,1,145891,155,m,93,-62
F,1,145984,93,o,62,-31
F,1,146046,125,s,47,-78
F,1,146093,126,t,62,-64
F,1,146155,142, ,125,-17
F,1,146280,126,o,126,0
F,1,146406,124,f,62,-62
F,1,146468,109, ,203,94
F,1,146671,125,t,109,-16
F,1,146780,125,h,78,-47
F,1,146858,141,e,141,0
F,1,146999,141,s,125,-16
F,1,147124,142,e,78,-64
F,1,147202,188, ,141,-47
F,1,147343,172,w,126,-46
F,1,147469,155,e,93,-62
F,1,147562,187,r,109,-78
F,1,147671,141,e,78,-63
F,1,147749,172, ,109,-63
F,1,147858,125,l,110,-15
F,1,147968,125,a,62,-63
F,1,148030,141,r,235,94
F,1,148265,109,g,78,-31
F,1,148343,140,e,125,-15
F,1,148468,94,n,500,406
F,1,148968,187,l,78,-109
F,1,149046,141,y,78,-63
F,1,149124,172, ,359,187
F,1,149483,141,c,79,-62
F,1,149562,171,o,62,-109
F,1,149624,125,n,94,-31
F,1,149718,109,c,203,94
F,1,149921,157,e,95,-62
F,1,150016,155,r,280,125
F,1,150296,157,n,109,-48
F,1,150405,125,e,219,94
F,1,150624,125,d,78,-47
F,1,150702,156, ,141,-15
F,1,150843,140,w,78,-62
F,1,150921,142,i,94,-48
F,1,151015,125,t,125,0
F,1,151140,188,h,0,-188
F,1,151140,172, ,922,750
F,1,152062,109,h,140,31
F,1,152202,156, ,125,-31
F,1,152327,110,t,78,-32
F,1,152405,141,h,110,-31
F,1,152515,156,e,78,-78
F,1,152593,172, ,140,-32
F,1,152733,95,m,172,77
F,1,152905,94,o,32,-62
F,1,152937,140,e,750,610
F,1,153687,156,v,125,-31
F,1,153812,125,e,125,0
F,1,153937,109,m,93,-16
F,1,154030,157,e,141,-16
F,1,154171,94,n,125,31
F,1,154296,109,t,187,78
F,1,154483,94,s,126,32
F,1,154609,156, ,328,172
F,1,154937,109,o,46,-63
F,1,154983,172,f,63,-109
F,1,155046,203, ,156,-47
F,1,155202,125,s,94,-31
F,1,155296,141,m,125,-16
F,1,155421,109,a,125,16
F,1,155546,203,l,281,78
F,1,155827,78,l,203,125
F,1,156030,125, ,157,32
F,1,156187,140,g,171,31
F,1,156358,79,i,469,390
F,1,156827,94,r,141,47
F,1,156968,94,e,172,78
F,1,157140,109,e,62,-47
F,1,157202,156,n,78,-78
F,1,157280,157, ,157,0
F,1,157437,109,p,187,78
F,1,157624,125,i,63,-62
F,1,157687,125,e,343,218
F,1,158030,141,c,188,47
F,1,158218,172,e,125,-47
F,1,158343,125,s,328,203
F,1,158671,94,o,437,343
F,1,159108,157, ,141,-16
F,1,159249,125,o,188,63
F,1,159437,78, ,390,312
F,1,159827,172,f,110,-62
F,1,159937,140, ,187,47
F,1,160124,94,p,141,47
F,1,160265,172,e,484,312
F,1,160749,141,a,125,-16
F,1,160874,172,p,109,-63
F,1,160983,204,e,94,-110
F,1,161077,156,r,313,157
F,1,161390,140,",",78,-62
F,1,161468,172, ,187,15
F,1,161655,141,w,78,-63
F,1,161733,172,j,110,-62
F,1,161843,78,i,876,798
F,1,162719,171,h,77,-94
F,1,162796,109,i,78,-31
F,1,162874,141,c,282,141
F,1,163156,140,h,282,142
F,1,163438,139, ,155,16
F,1,163593,140,i,78,-62
F,1,163671,141,s,78,-63
F,1,163749,141, ,156,15
F,1,163905,110,o,172,62
F,1,164077,78,d,141,63
F,1,164218,125,d,78,-47
F,1,164296,125, ,281,156
F,1,164577,78,b,156,78
F,1,164733,110,e,250,140
F,1,164983,94,c,125,31
F,1,165108,142,a,172,30
F,1,165280,94,u,94,0
F,1,165374,141,s,47,-94
F,1,165421,156,e,94,-62
F,1,165515,156, ,234,78
F,1,165749,172,o,109,-63
F,1,165858,110,n,94,-16
F,1,165952,141, ,78,-63
F,1,166030,141,t,94,-47
F,1,166124,156,h,78,-78
F,1,166202,156,e,63,-93
F,1,166265,172, ,234,62
F,1,166499,63,h,313,250
F,1,166812,109,w,187,78
F,1,166999,47,j,281,234
F,1,167280,110,o,297,187
F,1,167577,189,l,94,-95
F,1,167671,219,e,78,-141
F,1,167749,219, ,1484,1265
F,1,169233,125,h,110,-15
F,1,169343,109,o,140,31
F,1,169483,141,l,94,-47
F,1,169577,141,e,64,-77
F,1,169641,171, ,186,15
F,1,169827,125,i,125,0
F,1,169952,188,t,141,-47
F,1,170093,187, ,140,-47
F,1,170233,125,w,79,-46
F,1,170312,218,a,125,-93
F,1,170437,140,s,156,16
F,1,170593,172,n,125,-47
F,1,170718,156,t,78,-78
F,1,170796,187, ,1234,1047
F,1,172030,94,',157,63
F,1,172187,109,t,62,-47
F,1,172249,156, ,172,16
F,1,172421,109,t,109,0
F,1,172530,125,h,79,-46
F,1,172609,140,e,78,-62
F,1,172687,156, ,156,0
F,1,172843,110,s,110,0
F,1,172953,109,m,93,-16
F,1,173046,141,a,109,-32
F,1,173155,63,l,110,47
F,1,173265,109,l,109,0
F,1,173374,125, ,109,-16
F,1,173483,94,g,204,110
F,1,173687,140,r,93,-47
F,1,173780,125,e,157,32
F,1,173937,140,e,78,-62
F,1,174015,125,n,62,-63
F,1,174077,172, ,125,-47
F,1,174202,141,p,141,0
F,1,174343,140,i,47,-93
F,1,174390,125,e,250,125
F,1,174640,93,c,172,79
F,1,174812,171,e,78,-93
F,1,174890,125,s,93,-32
F,1,174983,141, ,94,-47
F,1,175077,156,o,110,-46
F,1,175187,156,f,78,-78
F,1,175265,187, ,156,-31
F,1,175421,156,p,156,0
F,1,175577,110,a,94,-16
F,1,175671,125,p,125,0
F,1,175796,172,e,78,-94
F,1,175874,156,r,63,-93
F,1,175937,140, ,171,31
F,1,176108,110,t,63,-47
F,1,176171,141,h,62,-79
F,1,176233,157,a,79,-78
F,1,176312,140,t,46,-94
F,1,176358,172, ,141,-31
F,1,176499,172,w,94,-78
F,1,176593,140,e,62,-78
F,1,176655,172,r,126,-46
F,1,176781,156,e,77,-79
F,1,176858,188, ,125,-63
F,1,176983,110,u,172,62
F,1,177155,110,n,203,93
F,1,177358,94,h,63,-31
F,1,177421,109,a,109,0
F,1,177530,63,p,110,47
F,1,177640,125,p,93,-32
F,1,177733,110,y,235,125
F,1,177968,157,.,NA,NA
F,2,250,141,Y,610,469
F,2,860,109,M,187,78
F,2,1047,156,y,110,-46
F,2,1157,140, ,218,78
F,2,1375,141,f,110,-31
F,2,1485,141,a,218,77
F,2,1703,110,v,94,-16
F,2,1797,110,o,203,93
F,2,2000,94,r,78,-16
F,2,2078,110,i,125,15
F,2,2203,125,t,141,16
F,2,2344,156,e,109,-47
F,2,2453,141, ,250,109
F,2,2703,94,f,32,-62
F,2,2735,93,o,125,32
F,2,2860,109,o,109,0
F,2,2969,125,d,94,-31
F,2,3063,187, ,2844,2657
F,2,5907,109,i,93,-16
F,2,6000,110,s,94,-16
F,2,6094,125, ,2438,2313
F,2,8532,140,s,93,-47
F,2,8625,157,p,219,62
F,2,8844,94,g,2031,1937
F,2,10875,188,a,78,-110
F,2,10953,141,g,126,-15
F,2,11079,140,h,203,63
F,2,11282,156,e,93,-63
F,2,11375,110,t,157,47
F,2,11532,93,t,62,-31
F,2,11594,172,i,141,-31
F,2,11735,156, ,109,-47
F,2,11844,141,a,78,-63
F,2,11922,141,n,110,-31
F,2,12032,125,d,46,-79
F,2,12078,157, ,625,468
F,2,12703,110,m,79,-31
F,2,12782,125,e,156,31
F,2,12938,187,a,94,-93
F,2,13032,109,t,265,156
F,2,13297,110,b,63,-47
F,2,13360,172,a,125,-47
F,2,13485,93,l,140,47
F,2,13625,125,l,94,-31
F,2,13719,141,s,109,-32
F,2,13828,125,",",1219,1094
F,2,15047,172, ,125,-47
F,2,15172,172,w,141,-31
F,2,15313,140,h,94,-46
F,2,15407,140,i,156,16
F,2,15563,94,c,62,-32
F,2,15625,141,h,3797,3656
F,2,19422,141,s,63,-78
F,2,19485,109,.,203,94
F,2,19688,125, ,3687,3562
F,2,23375,94,",",47,-47
F,2,23422,172, ,125,-47
F,2,23547,141,a,125,-16
F,2,23672,125,n,110,-15
F,2,23782,171,d,78,-93
F,2,23860,109, ,218,109
F,2,24078,110,t,64,-46
F,2,24142,108,h,108,0
F,2,24250,172,a,63,-109
F,2,24313,140,t,156,16
F,2,24469,156,',78,-78
F,2,24547,156,s,78,-78
F,2,24625,157, ,203,46
F,2,24828,111,m,172,61
F,2,25000,110,o,63,-47
F,2,25063,172,s,140,-32
F,2,25203,125,t,125,0
F,2,25328,141,l,94,-47
F,2,25422,156,y,63,-93
F,2,25485,187, ,953,766
F,2,26438,140,d,94,-46
F,2,26532,109,o,109,0
F,2,26641,187,w,109,-78
F,2,26750,141,n,110,-31
F,2,26860,187, ,156,-31
F,2,27016,156,t,62,-94
F,2,27078,157,o,141,-16
F,2,27219,156, ,1766,1610
F,2,28985,140,t,62,-78
F,2,29047,125,h,63,-62
F,2,29110,140,e,78,-62
F,2,29188,125, ,156,31
F,2,29344,125,f,94,-31
F,2,29438,109,a,187,78
F,2,29625,78,c,219,141
F,2,29844,125,t,125,0
F,2,29969,156, ,94,-62
F,2,30063,125,t,125,0
F,2,30188,125,h,62,-63
F,2,30250,172,a,48,-124
F,2,30298,155,t,62,-93
F,2,30360,172, ,172,0
F,2,30532,109,i,93,-16
F,2,30625,173,t,141,-32
F,2,30766,141, ,156,15
F,2,30922,172,r,110,-62
F,2,31032,156,e,93,-63
F,2,31125,78,m,141,63
F,2,31266,141,i,94,-47
F,2,31360,140,n,78,-62
F,2,31438,140,d,78,-62
F,2,31516,156,s,125,-31
F,2,31641,156, ,125,-31
F,2,31766,109,m,78,-31
F,2,31844,156,e,94,-62
F,2,31938,156, ,78,-78
F,2,32016,125,o,94,-31
F,2,32110,156,f,78,-78
F,2,32188,156, ,187,31
F,2,32375,141,h,141,0
F,2,32516,125,o,125,0
F,2,32641,141,m,62,-79
F,2,32703,172,e,63,-109
F,2,32766,141, ,156,15
F,2,32922,125,a,172,47
F,2,33094,125,n,78,-47
F,2,33172,188,d,94,-94
F,2,33266,156, ,860,704
F,2,34126,109,g,124,15
F,2,34250,142,r,125,-17
F,2,34375,110,o,78,-32
F,2,34453,157,w,141,-16
F,2,34594,188,i,109,-79
F,2,34703,141,n,63,-78
F,2,34766,141,g,78,-63
F,2,34844,141, ,188,47
F,2,35032,125,u,93,-32
F,2,35125,125,p,235,110
F,2,35360,172,.,93,-79
F,2,35453,141, ,954,813
F,2,36407,125,I,2937,2812
F,2,39344,141,M,281,140
F,2,39625,219,y,110,-109
F,2,39735,172, ,828,656
F,2,40563,109,M,234,125
F,2,40797,141,o,78,-63
F,2,40875,141,m,79,-62
F,2,40954,140, ,156,16
F,2,41110,109,i,78,-31
F,2,41188,140,s,109,-31
F,2,41297,156, ,4797,4641
F,2,46094,141,s,188,47
F,2,46282,125, ,282,157
F,2,46564,108,I,139,31
F,2,46703,125,t,111,-14
F,2,46814,124,a,77,-47
F,2,46891,94,l,203,109
F,2,47094,94,i,109,15
F,2,47203,141,a,141,0
F,2,47344,125,n,125,0
F,2,47469,156, ,109,-47
F,2,47578,141,a,79,-62
F,2,47657,109,n,140,31
F,2,47797,125,d,47,-78
F,2,47844,109, ,141,32
F,2,47985,109,o,156,47
F,2,48141,156,f,422,266
F,2,48563,156, ,219,63
F,2,48782,125,c,78,-47
F,2,48860,125,o,79,-46
F,2,48939,108,u,218,110
F,2,49157,156,r,156,0
F,2,49313,156,s,109,-47
F,2,49422,156,e,47,-109
F,2,49469,125, ,156,31
F,2,49625,111,h,32,-79
F,2,49657,156,a,203,47
F,2,49860,109,s,109,0
F,2,49969,125, ,109,-16
F,2,50078,157,a,110,-47
F,2,50188,140, ,578,438
F,2,50766,79,n,47,-32
F,2,50813,125, ,156,31
F,2,50969,94,o,31,-63
F,2,51000,78,r,516,438
F,2,51516,141,l,62,-79
F,2,51578,125,d,47,-78
F,2,51625,141, ,297,156
F,2,51922,141,r,78,-63
F,2,52000,141,e,219,78
F,2,52219,109,c,63,-46
F,2,52282,126,i,265,139
F,2,52547,110,p,63,-47
F,2,52610,172,e,234,62
F,2,52844,156, ,203,47
F,2,53047,94,t,63,-31
F,2,53110,141,h,31,-110
F,2,53141,203,a,79,-124
F,2,53220,155,t,62,-93
F,2,53282,171, ,453,282
F,2,53735,78,s,31,-47
F,2,53766,94,h,125,31
F,2,53891,156,e,94,-62
F,2,53985,109, ,172,63
F,2,54157,94,g,62,-32
F,2,54219,95,o,126,31
F,2,54345,124,t,77,-47
F,2,54422,172, ,125,-47
F,2,54547,110,t,360,250
F,2,54907,78,f,187,109
F,2,55094,125,r,31,-94
F,2,55125,172,o,110,-62
F,2,55235,109,m,93,-16
F,2,55328,141, ,157,16
F,2,55485,93,h,62,-31
F,2,55547,188,e,78,-110
F,2,55625,157,r,94,-63
F,2,55719,172, ,156,-16
F,2,55875,94,m,157,63
F,2,56032,93,o,156,63
F,2,56188,109,m,1562,1453
F,2,57750,63,o,172,109
F,2,57922,94,m,78,-16
F,2,58000,125, ,672,547
F,2,58672,94,w,78,-16
F,2,58750,157,h,95,-62
F,2,58845,140,o,108,-32
F,2,58953,125, ,157,32
F,2,59110,93,g,93,0
F,2,59203,110,o,157,47
F,2,59360,172,t,63,-109
F,2,59423,234, ,249,15
F,2,59672,141,i,78,-63
F,2,59750,172,t,94,-78
F,2,59844,156, ,266,110
F,2,60110,93,f,218,125
F,2,60328,110,r,63,-47
F,2,60391,141,o,125,-16
F,2,60516,141,m,109,-32
F,2,60625,141, ,157,16
F,2,60782,93,h,93,0
F,2,60875,157,e,78,-79
F,2,60953,189,r,173,-16
F,2,61126,140, ,156,16
F,2,61282,93,m,156,63
F,2,61438,173,o,109,-64
F,2,61547,125,m,47,-78
F,2,61594,125, ,219,94
F,2,61813,172,a,94,-78
F,2,61907,109,n,15,-94
F,2,61922,157,d,47,-110
F,2,61969,141, ,172,31
F,2,62141,156,s,94,-62
F,2,62235,140,o,78,-62
F,2,62313,156, ,156,0
F,2,62469,156,o,78,-78
F,2,62547,110,n,172,62
F,2,62719,109,.,109,0
F,2,62828,94, ,6594,6500
F,2,69422,110,I,313,203
F,2,69735,156,t,78,-78
F,2,69813,156, ,656,500
F,2,70469,141,a,125,-16
F,2,70594,94,l,126,32
F,2,70720,108,s,124,16
F,2,70844,109,o,63,-46
F,2,70907,93, ,359,266
F,2,71266,125,j,250,125
F,2,71516,109,u,62,-47
F,2,71578,157,s,94,-63
F,2,71672,141,t,47,-94
F,2,71719,219, ,219,0
F,2,71938,140,t,15,-125
F,2,71953,219,a,469,250
F,2,72422,156,s,125,-31
F,2,72547,125,t,172,47
F,2,72719,94,s,344,250
F,2,73063,140,e,140,0
F,2,73203,125,s,125,0
F,2,73328,157, ,235,78
F,2,73563,125,g,140,15
F,2,73703,79,o,110,31
F,2,73813,125,o,109,-16
F,2,73922,141,d,172,31
F,2,74094,156,",",63,-93
F,2,74157,156, ,140,-16
F,2,74297,125,a,125,0
F,2,74422,125,n,110,-15
F,2,74532,125,d,15,-110
F,2,74547,156, ,10953,10797
F,2,85500,125,s,63,-62
F,2,85563,125,h,125,0
F,2,85688,172,e,78,-94
F,2,85766,156, ,125,-31
F,2,85891,125,u,94,-31
F,2,85985,125,s,109,-16
F,2,86094,109,u,109,0
F,2,86203,110,a,250,140
F,2,86453,79,l,141,62
F,2,86594,109,l,95,-14
F,2,86689,155,y,61,-94
F,2,86750,189, ,125,-64
F,2,86875,110,m,94,-16
F,2,86969,125,a,109,-16
F,2,87078,125,k,80,-45
F,2,87158,186,e,139,-47
F,2,87297,172,s,125,-47
F,2,87422,156, ,110,-46
F,2,87532,171,i,78,-93
F,2,87610,218,t,93,-125
F,2,87703,157, ,204,47
F,2,87907,172,o,78,-94
F,2,87985,140,n,78,-62
F,2,88063,156, ,1312,1156
F,2,89375,94,m,3688,3594
F,2,93063,172,h,62,-110
F,2,93125,141,o,219,78
F,2,93344,94,l,125,31
F,2,93469,125,d,94,-31
F,2,93563,125,i,640,515
F,2,94203,125,i,63,-62
F,2,94266,109,d,109,0
F,2,94375,141,a,219,78
F,2,94594,156,y,109,-47
F,2,94703,157,s,125,-32
F,2,94828,141, ,204,63
F,2,95032,125,o,1109,984
F,2,96141,141,o,531,390
F,2,96672,141,u,125,-16
F,2,96797,110,t,203,93
F,2,97000,125,s,94,-31
F,2,97094,78,i,141,63
F,2,97235,78,d,156,78
F,2,97391,142,e,47,-95
F,2,97438,172, ,140,-32
F,2,97578,125,o,79,-46
F,2,97657,156,f,93,-63
F,2,97750,141, ,203,62
F,2,97953,110,l,204,94
F,2,98157,78,i,156,78
F,2,98313,125,k,47,-78
F,2,98360,156,e,62,-94
F,2,98422,126, ,563,437
F,2,98985,140,T,234,94
F,2,99219,63,h,141,78
F,2,99360,156,a,93,-63
F,2,99453,141,n,79,-62
F,2,99532,140,k,406,266
F,2,99938,125,s,156,31
F,2,100094,125,g,172,47
F,2,100266,125,i,187,62
F,2,100453,125,i,375,250
F,2,100828,110,v,157,47
F,2,100985,156,i,109,-47
F,2,101094,109,n,94,-15
F,2,101188,109,g,125,16
F,2,101313,109,.,NA,NA
G,1,34,92,F,152,60
G,1,186,136,a,116,-20
G,1,302,88,r,76,-12
G,1,378,72, ,446,374
G,1,824,156,o,100,-56
G,1,924,92,u,110,18
G,1,1034,35,t,87,52
G,1,1121,64, ,125,61
G,1,1246,152,i,80,-72
G,1,1326,120,n,80,-40
G,1,1406,125, ,72,-53
G,1,1478,112,t,53,-59
G,1,1531,91,h,111,20
G,1,1642,88,e,80,-8
G,1,1722,56, ,307,251
G,1,2029,115,u,123,8
G,1,2152,108,n,157,49
G,1,2309,64,c,52,-12
G,1,2361,96,h,100,4
G,1,2461,120,a,92,-28
G,1,2553,80,r,175,95
G,1,2728,76,t,157,81
G,1,2885,180,e,116,-64
G,1,3001,119,d,104,-15
G,1,3105,91, ,375,284
G,1,3480,64,b,97,33
G,1,3577,152,a,120,-32
G,1,3697,96,c,56,-40
G,1,3753,116,k,209,93
G,1,3962,84,w,188,104
G,1,4150,73,a,139,66
G,1,4289,76,t,147,71
G,1,4436,136,e,72,-64
G,1,4508,84,r,154,70
G,1,4662,140,s,128,-12
G,1,4790,68, ,300,232
G,1,5090,75,o,114,39
G,1,5204,84,f,88,4
G,1,5292,52, ,85,33
G,1,5377,105,t,53,-52
G,1,5430,92,h,76,-16
G,1,5506,108,e,55,-53
G,1,5561,77, ,205,128
G,1,5766,116,u,52,-64
G,1,5818,124,n,257,133
G,1,6075,64,f,148,84
G,1,6223,92,a,1061,969
G,1,7284,56,f,220,164
G,1,7504,156,a,112,-44
G,1,7616,112,s,206,94
G,1,7822,87,h,210,123
G,1,8032,87,i,203,116
G,1,8235,120,o,56,-64
G,1,8291,88,n,114,26
G,1,8405,88,a,68,-20
G,1,8473,80,b,130,50
G,1,8603,108,l,112,4
G,1,8715,84,e,68,-16
G,1,8783,72, ,185,113
G,1,8968,44,n,3,-41
G,1,8971,100,e,213,113
G,1,9184,88,d,76,-12
G,1,9260,48, ,112,64
G,1,9372,84,o,48,-36
G,1,9420,51,f,108,57
G,1,9528,63, ,48,-15
G,1,9576,92,t,1189,1097
G,1,10765,80,e,76,-4
G,1,10841,80,n,118,38
G,1,10959,92,d,40,-52
G,1,10999,55, ,124,69
G,1,11123,76,o,60,-16
G,1,11183,60,f,79,19
G,1,11262,77, ,101,24
G,1,11363,148,t,57,-91
G,1,11420,79,h,83,4
G,1,11503,76,e,60,-16
G,1,11563,80, ,172,92
G,1,11735,140,w,76,-64
G,1,11811,80,e,406,326
G,1,12217,83,s,203,120
G,1,12420,52,t,125,73
G,1,12545,97,e,61,-36
G,1,12606,84,r,84,0
G,1,12690,64,n,87,23
G,1,12777,80, ,175,95
G,1,12952,84,s,88,4
G,1,13040,140,p,104,-36
G,1,13144,116,i,88,-28
G,1,13232,52,t,173,121
G,1,13405,111,a,68,-43
G,1,13473,91,l,55,-36
G,1,13528,93, ,1057,964
G,1,14585,56,r,184,128
G,1,14769,104,a,72,-32
G,1,14841,72,l,56,-16
G,1,14897,80, ,110,30
G,1,15007,116,a,159,43
G,1,15166,104,r,157,53
G,1,15323,72,m,192,120
G,1,15515,68, ,290,222
G,1,15805,76,o,121,45
G,1,15926,59,f,115,56
G,1,16041,100, ,68,-32
G,1,16109,112,t,144,32
G,1,16253,64,h,15,-49
G,1,16268,104,e,101,-3
G,1,16369,60, ,592,532
G,1,16961,76,a,102,26
G,1,17063,92,l,68,-24
G,1,17131,80,a,468,388
G,1,17599,59,x,77,18
G,1,17676,93,y,238,145
G,1,17914,72, ,287,215
G,1,18201,60,l,160,100
G,1,18361,88,i,95,7
G,1,18456,69,e,161,92
G,1,18617,68,s,60,-8
G,1,18677,64, ,152,88
G,1,18829,112,a,108,-4
G,1,18937,61, ,223,162
G,1,19160,68,s,90,22
G,1,19250,80,m,113,33
G,1,19363,76,a,79,3
G,1,19442,61,l,146,85
G,1,19588,79,l,72,-7
G,1,19660,76, ,189,113
G,1,19849,149,u,69,-80
G,1,19918,127,n,135,8
G,1,20053,125,r,76,-49
G,1,20129,112,e,140,28
G,1,20269,95,g,115,20
G,1,20384,77,a,95,18
G,1,20479,80,r,196,116
G,1,20675,104,d,132,28
G,1,20807,188,e,136,-52
G,1,20943,76,d,64,-12
G,1,21007,104, ,242,138
G,1,21249,73,y,141,68
G,1,21390,84,e,113,29
G,1,21503,40,l,114,74
G,1,21617,63,l,136,73
G,1,21753,60,o,72,12
G,1,21825,84,w,76,-8
G,1,21901,92, ,162,70
G,1,22063,100,s,77,-23
G,1,22140,115,u,75,-40
G,1,22215,92,n,250,158
G,1,22465,104,.,156,52
G,1,22621,52, ,609,557
G,1,23230,72,O,408,336
G,1,23638,35,b,371,336
G,1,24009,82,r,82,0
G,1,24091,32,b,114,82
G,1,24205,88,i,105,17
G,1,24310,77,t,97,20
G,1,24407,120,i,72,-48
G,1,24479,100,n,132,32
G,1,24611,48,g,59,11
G,1,24670,89, ,139,50
G,1,24809,111,t,95,-16
G,1,24904,53,h,186,133
G,1,25090,72,i,113,41
G,1,25203,68,s,65,-3
G,1,25268,63, ,101,38
G,1,25369,52,a,169,117
G,1,25538,92,t,100,8
G,1,25638,61, ,128,67
G,1,25766,91,a,43,-48
G,1,25809,76, ,416,340
G,1,26225,88,d,107,19
G,1,26332,72,i,108,36
G,1,26440,60,s,180,120
G,1,26620,76,t,170,94
G,1,26790,80,a,128,48
G,1,26918,84,n,115,31
G,1,27033,108,c,72,-36
G,1,27105,96,e,91,-5
G,1,27196,49, ,123,74
G,1,27319,80,o,36,-44
G,1,27355,80,f,127,47
G,1,27482,44, ,140,96
G,1,27622,92,r,88,-4
G,1,27710,124,o,76,-48
G,1,27786,84,u,132,48
G,1,27918,75,g,64,-11
G,1,27982,84,h,178,94
G,1,28160,89,l,123,34
G,1,28283,56,y,80,24
G,1,28363,61, ,632,571
G,1,28995,104,n,244,140
G,1,29239,56,i,31,-25
G,1,29270,97,n,137,40
G,1,29407,92,e,159,67
G,1,29566,92,t,299,207
G,1,29865,78,y,665,587
G,1,30530,80,t,218,138
G,1,30748,100,w,64,-36
G,1,30812,68,o,76,8
G,1,30888,92, ,130,38
G,1,31018,68,m,185,117
G,1,31203,45,i,159,114
G,1,31362,40,l,115,75
G,1,31477,64,l,170,106
G,1,31647,56,i,164,108
G,1,31811,100,o,64,-36
G,1,31875,64,n,83,19
G,1,31958,80, ,92,12
G,1,32050,76,m,179,103
G,1,32229,60,i,164,104
G,1,32393,68,l,76,8
G,1,32469,56,e,166,110
G,1,32635,76,s,57,-19
G,1,32692,59, ,148,89
G,1,32840,64,i,56,-8
G,1,32896,84,s,96,12
G,1,32992,60, ,148,88
G,1,33140,64,a,28,-36
G,1,33168,48,n,138,90
G,1,33306,67, ,291,224
G,1,33597,68,u,238,170
G,1,33835,43,t,124,81
G,1,33959,48,t,127,79
G,1,34086,108,e,56,-52
G,1,34142,92,r,126,34
G,1,34268,60,l,95,35
G,1,34363,76,y,84,8
G,1,34447,72, ,193,121
G,1,34640,132,i,52,-80
G,1,34692,140,n,273,133
G,1,34965,80,s,56,-24
G,1,35021,100,i,118,18
G,1,35139,72,g,112,40
G,1,35251,60,n,143,83
G,1,35394,96,i,198,102
G,1,35592,76,f,285,209
G,1,35877,84,i,121,37
G,1,35998,40,c,145,105
G,1,36143,52,a,108,56
G,1,36251,56,n,81,25
G,1,36332,80,t,270,190
G,1,36602,88, ,353,265
G,1,36955,72,l,164,92
G,1,37119,75,i,60,-15
G,1,37179,59,t,120,61
G,1,37299,88,t,88,0
G,1,37387,56,l,89,33
G,1,37476,109,e,81,-28
G,1,37557,55, ,153,98
G,1,37710,45,b,143,98
G,1,37853,160,l,96,-64
G,1,37949,108,u,180,72
G,1,38129,69,e,44,-25
G,1,38173,72, ,187,115
G,1,38360,85,g,128,43
G,1,38488,48,r,188,140
G,1,38676,40,e,125,85
G,1,38801,91,e,80,-11
G,1,38881,64,n,165,101
G,1,39046,32, ,193,161
G,1,39239,136,p,67,-69
G,1,39306,108,l,100,-8
G,1,39406,104,a,137,33
G,1,39543,68,n,90,22
G,1,39633,128,e,104,-24
G,1,39737,88,t,100,12
G,1,39837,80, ,758,678
G,1,40595,100,w,64,-36
G,1,40659,68,h,155,87
G,1,40814,76,o,68,-8
G,1,40882,101,r,415,314
G,1,41297,148,s,88,-60
G,1,41385,96,e,60,-36
G,1,41445,84, ,204,120
G,1,41649,60,a,96,36
G,1,41745,88,p,144,56
G,1,41889,52,e,1793,1741
G,1,43682,132,d,218,86
G,1,43900,108,e,227,119
G,1,44127,84,s,176,92
G,1,44303,68,c,185,117
G,1,44488,59,e,176,117
G,1,44664,108,n,307,199
G,1,44971,95,d,152,57
G,1,45123,160,e,124,-36
G,1,45247,76,d,84,8
G,1,45331,92, ,575,483
G,1,45906,55,l,160,105
G,1,46066,72,i,76,4
G,1,46142,100,f,117,17
G,1,46259,68, ,86,18
G,1,46345,76,f,558,482
G,1,46903,80,e,114,34
G,1,47017,68, ,80,12
G,1,47097,72,f,72,0
G,1,47169,80,o,121,41
G,1,47290,68,r,79,11
G,1,47369,89,m,135,46
G,1,47504,92,s,118,26
G,1,47622,68, ,393,325
G,1,48015,87,a,179,92
G,1,48194,132,r,72,-60
G,1,48266,116,e,100,-16
G,1,48366,52, ,99,47
G,1,48465,72,s,76,4
G,1,48541,80,o,56,-24
G,1,48597,92, ,147,55
G,1,48744,104,a,124,20
G,1,48868,76,m,93,17
G,1,48961,93,a,786,693
G,1,49747,108,z,250,142
G,1,49997,116,i,76,-40
G,1,50073,92,n,60,-32
G,1,50133,56,g,122,66
G,1,50255,84,l,102,18
G,1,50357,60,y,80,20
G,1,50437,80, ,242,162
G,1,50679,83,p,195,112
G,1,50874,64,r,81,17
G,1,50955,124,i,80,-44
G,1,51035,100,m,173,73
G,1,51208,91,i,95,4
G,1,51303,72,t,153,81
G,1,51456,84,i,248,164
G,1,51704,101,v,166,65
G,1,51870,92,e,80,-12
G,1,51950,76, ,128,52
G,1,52078,71,t,63,-8
G,1,52141,96,h,120,24
G,1,52261,80,a,135,55
G,1,52396,64,t,38,-26
G,1,52434,70, ,119,49
G,1,52553,68,t,44,-24
G,1,52597,85,h,106,21
G,1,52703,92,e,84,-8
G,1,52787,116,y,68,-48
G,1,52855,85, ,391,306
G,1,53246,80,s,190,110
G,1,53436,71,t,51,-20
G,1,53487,60,i,171,111
G,1,53658,52,l,107,55
G,1,53765,100,l,92,-8
G,1,53857,72, ,53,-19
G,1,53910,112,t,91,-21
G,1,54001,86,h,153,67
G,1,54154,71,i,63,-8
G,1,54217,97,n,173,76
G,1,54390,136,k,128,-8
G,1,54518,76, ,403,327
G,1,54921,64,d,88,24
G,1,55009,72,i,98,26
G,1,55107,60,g,88,28
G,1,55195,72,i,98,26
G,1,55293,68,t,200,132
G,1,55493,80,a,64,-16
G,1,55557,104,l,76,-28
G,1,55633,144, ,120,-24
G,1,55753,84,w,203,119
G,1,55956,28,a,96,68
G,1,56052,79,t,211,132
G,1,56263,68,c,85,17
G,1,56348,88,h,116,28
G,1,56464,72,e,184,112
G,1,56648,64,s,52,-12
G,1,56700,84, ,92,8
G,1,56792,76,a,108,32
G,1,56900,148,r,108,-40
G,1,57008,84,e,52,-32
G,1,57060,96, ,247,151
G,1,57307,123,a,83,-40
G,1,57390,52, ,276,224
G,1,57666,76,p,116,40
G,1,57782,104,r,80,-24
G,1,57862,108,e,205,97
G,1,58067,56,t,125,69
G,1,58192,72,t,154,82
G,1,58346,96,y,56,-40
G,1,58402,48, ,148,100
G,1,58550,75,n,55,-20
G,1,58605,64,e,176,112
G,1,58781,65,a,138,73
G,1,58919,80,t,68,-12
G,1,58987,72, ,173,101
G,1,59160,103,i,107,4
G,1,59267,128,d,72,-56
G,1,59339,93,e,168,75
G,1,59507,104,a,68,-36
G,1,59575,104,.,84,-20
G,1,59659,72, ,810,738
G,1,60469,88,T,79,-9
G,1,60548,69,h,142,73
G,1,60690,60,i,52,-8
G,1,60742,101,s,101,0
G,1,60843,47, ,189,142
G,1,61032,108,p,72,-36
G,1,61104,64,l,94,30
G,1,61198,48,a,88,40
G,1,61286,64,n,86,22
G,1,61372,136,e,108,-28
G,1,61480,80,t,28,-52
G,1,61508,64, ,178,114
G,1,61686,104,h,69,-35
G,1,61755,120,a,71,-49
G,1,61826,129,s,292,163
G,1,62118,100,",",108,8
G,1,62226,92, ,119,27
G,1,62345,80,o,83,3
G,1,62428,68,r,162,94
G,1,62590,60, ,307,247
G,1,62897,64,r,168,104
G,1,63065,72,a,162,90
G,1,63227,64,t,89,25
G,1,63316,88,h,106,18
G,1,63422,80,t,141,61
G,1,63563,112,e,215,103
G,1,63778,73, ,1308,1235
G,1,65086,84,h,182,98
G,1,65268,140,e,68,-72
G,1,65336,112,r,96,-16
G,1,65432,56, ,292,236
G,1,65724,44,d,377,333
G,1,66101,91,h,121,30
G,1,66222,128,a,72,-56
G,1,66294,100,d,100,0
G,1,66394,140,",",136,-4
G,1,66530,64, ,1069,1005
G,1,67599,88,h,92,4
G,1,67691,128,a,64,-64
G,1,67755,132,d,136,4
G,1,67891,140,",",120,-20
G,1,68011,76, ,136,60
G,1,68147,124,a,88,-36
G,1,68235,48, ,172,124
G,1,68407,76,p,130,54
G,1,68537,68,r,64,-4
G,1,68601,92,o,248,156
G,1,68849,76,l,733,657
G,1,69582,59,b,103,44
G,1,69685,76,l,140,64
G,1,69825,84,e,71,-13
G,1,69896,77,m,167,90
G,1,70063,123,",",119,-4
G,1,70182,72, ,134,62
G,1,70316,60,w,80,20
G,1,70396,65,h,118,53
G,1,70514,80,i,84,4
G,1,70598,76,c,108,32
G,1,70706,69,h,53,-16
G,1,70759,123, ,116,-7
G,1,70875,67,w,261,194
G,1,71136,84,a,16,-68
G,1,71152,124,s,128,4
G,1,71280,76, ,128,52
G,1,71408,76,t,80,4
G,1,71488,81,h,116,35
G,1,71604,91,i,84,-7
G,1,71688,83,s,373,290
G,1,72061,104,:,108,4
G,1,72169,84, ,606,522
G,1,72775,68,t,451,383
G,1,73226,76,m,162,86
G,1,73388,76,o,36,-40
G,1,73424,56,s,112,56
G,1,73536,83,t,51,-32
G,1,73587,64, ,186,122
G,1,73773,72,p,136,64
G,1,73909,72,e,28,-44
G,1,73937,64,o,188,124
G,1,74125,136,p,92,-44
G,1,74217,92,l,152,60
G,1,74369,80,e,72,-8
G,1,74441,44, ,123,79
G,1,74564,124,o,97,-27
G,1,74661,80,n,31,-49
G,1,74692,105, ,164,59
G,1,74856,72,i,84,12
G,1,74940,72,t,92,20
G,1,75032,76, ,131,55
G,1,75163,104,w,76,-28
G,1,75239,92,e,192,100
G,1,75431,124,r,80,-44
G,1,75511,168,e,108,-60
G,1,75619,68, ,194,126
G,1,75813,104,u,57,-47
G,1,75870,71,n,192,121
G,1,76062,64,h,108,44
G,1,76170,60,a,77,17
G,1,76247,61,p,119,58
G,1,76366,68,p,80,12
G,1,76446,72,y,116,44
G,1,76562,84, ,927,843
G,1,77489,84,f,80,-4
G,1,77569,76,o,107,31
G,1,77676,67,r,60,-7
G,1,77736,60, ,216,156
G,1,77952,100,p,129,29
G,1,78081,124,r,84,-40
G,1,78165,120,e,353,233
G,1,78518,84,t,129,45
G,1,78647,100,t,1033,933
G,1,79680,60,y,63,3
G,1,79743,73, ,185,112
G,1,79928,72,m,188,116
G,1,80116,96,u,108,12
G,1,80224,76,c,84,8
G,1,80308,84,h,84,0
G,1,80392,156, ,120,-36
G,1,80512,64,o,60,-4
G,1,80572,56,f,101,45
G,1,80673,64, ,64,0
G,1,80737,112,t,56,-56
G,1,80793,124,h,92,-32
G,1,80885,80,e,32,-48
G,1,80917,96, ,119,23
G,1,81036,91,t,125,34
G,1,81161,64,i,52,-12
G,1,81213,136,m,186,50
G,1,81399,84,e,254,170
G,1,81653,120,",",132,12
G,1,81785,68, ,299,231
G,1,82084,60,M,137,77
G,1,82221,76,a,64,-12
G,1,82285,64,n,140,76
G,1,82425,84,y,92,8
G,1,82517,44, ,1388,1344
G,1,83905,88,.,313,225
G,1,84218,60, ,219,159
G,1,84437,72,M,119,47
G,1,84556,103,a,96,-7
G,1,84652,60,n,157,97
G,1,84809,52,y,48,-4
G,1,84857,48, ,270,222
G,1,85127,68,s,28,-40
G,1,85155,76,o,117,41
G,1,85272,76,l,179,103
G,1,85451,115,i,127,12
G,1,85578,68,t,90,22
G,1,85668,64,i,189,125
G,1,85857,56,o,1036,980
G,1,86893,92,u,128,36
G,1,87021,52,t,104,52
G,1,87125,64,i,173,109
G,1,87298,104,o,64,-40
G,1,87362,76,n,72,-4
G,1,87434,88,s,2732,2644
G,1,90166,104, ,188,84
G,1,90354,148,w,127,-21
G,1,90481,97,e,206,109
G,1,90687,120,r,84,-36
G,1,90771,119,e,88,-31
G,1,90859,64, ,153,89
G,1,91012,73,s,73,0
G,1,91085,72,u,171,99
G,1,91256,52,g,116,64
G,1,91372,88,g,60,-28
G,1,91432,89,e,197,108
G,1,91629,120,s,148,28
G,1,91777,82,t,160,78
G,1,91937,168,e,175,7
G,1,92112,45, ,434,389
G,1,92546,64,f,94,30
G,1,92640,44,o,821,777
G,1,93461,64,d,67,3
G,1,93528,61, ,130,69
G,1,93658,68,f,60,-8
G,1,93718,76,o,113,37
G,1,93831,61,r,61,0
G,1,93892,60, ,94,34
G,1,93986,72,t,84,12
G,1,94070,69,h,117,48
G,1,94187,72,i,72,0
G,1,94259,80,s,76,-4
G,1,94335,64, ,178,114
G,1,94513,63,p,51,-12
G,1,94564,64,r,106,42
G,1,94670,84,o,91,7
G,1,94761,24,v,101,77
G,1,94862,96,l,191,95
G,1,95053,84,e,103,19
G,1,95156,68,m,909,841
G,1,96065,69,b,185,116
G,1,96250,84,l,7,-77
G,1,96257,61,e,745,684
G,1,97002,80,m,506,426
G,1,97508,104,",",108,4
G,1,97616,100, ,126,26
G,1,97742,76,b,149,73
G,1,97891,76,u,187,111
G,1,98078,23, ,70,47
G,1,98148,72,t,602,530
G,1,98750,73,t,109,36
G,1,98859,63, ,184,121
G,1,99043,68,m,152,84
G,1,99195,100,o,27,-73
G,1,99222,108,s,142,34
G,1,99364,97,t,97,0
G,1,99461,47, ,122,75
G,1,99583,96,o,64,-32
G,1,99647,68,f,127,59
G,1,99774,60, ,56,-4
G,1,99830,112,t,84,-28
G,1,99914,120,h,108,-12
G,1,100022,117,e,226,109
G,1,100248,96,s,203,107
G,1,100451,76,e,84,8
G,1,100535,56, ,326,270
G,1,100861,124,w,72,-52
G,1,100933,84,e,192,108
G,1,101125,140,r,72,-68
G,1,101197,144,e,108,-36
G,1,101305,52, ,177,125
G,1,101482,104,l,72,-32
G,1,101554,32,a,77,45
G,1,101631,84,r,128,44
G,1,101759,84,g,96,12
G,1,101855,100,e,146,46
G,1,102001,100,l,100,0
G,1,102101,72,y,144,72
G,1,102245,108, ,625,517
G,1,102870,68,c,85,17
G,1,102955,113,o,69,-44
G,1,103024,100,n,80,-20
G,1,103104,64,c,203,139
G,1,103307,132,e,80,-52
G,1,103387,116,r,100,-16
G,1,103487,84,n,133,49
G,1,103620,155,e,67,-88
G,1,103687,152,d,100,-52
G,1,103787,76, ,1084,1008
G,1,104871,88,w,84,-4
G,1,104955,77,i,84,7
G,1,105039,113,t,92,-21
G,1,105131,76,h,48,-28
G,1,105179,124, ,105,-19
G,1,105284,103,t,43,-60
G,1,105327,56,h,145,89
G,1,105472,72,e,12,-60
G,1,105484,72, ,210,138
G,1,105694,67,m,150,83
G,1,105844,100,o,43,-57
G,1,105887,69,v,189,120
G,1,106076,48,e,59,11
G,1,106135,49,m,93,44
G,1,106228,72,e,76,4
G,1,106304,60,n,99,39
G,1,106403,76,t,181,105
G,1,106584,96,s,88,-8
G,1,106672,60, ,204,144
G,1,106876,88,o,123,35
G,1,106999,79,f,114,35
G,1,107113,77, ,84,7
G,1,107197,57,t,395,338
G,1,107592,76,s,83,7
G,1,107675,76,m,111,35
G,1,107786,72,a,75,3
G,1,107861,61,l,121,60
G,1,107982,100,l,60,-40
G,1,108042,76, ,304,228
G,1,108346,88,g,107,19
G,1,108453,80,r,167,87
G,1,108620,57,e,134,77
G,1,108754,68,e,68,0
G,1,108822,112,n,116,4
G,1,108938,68, ,431,363
G,1,109369,68,p,174,106
G,1,109543,96,i,84,-12
G,1,109627,68,e,220,152
G,1,109847,124,c,355,231
G,1,110202,72,e,405,333
G,1,110607,103,s,95,-8
G,1,110702,52, ,136,84
G,1,110838,80,o,52,-28
G,1,110890,84,f,116,32
G,1,111006,64, ,171,107
G,1,111177,115,p,115,0
G,1,111292,89,a,161,72
G,1,111453,88,p,100,12
G,1,111553,164,e,104,-60
G,1,111657,100,r,207,107
G,1,111864,112,",",119,7
G,1,111983,93, ,317,224
G,1,112300,72,w,79,7
G,1,112379,73,h,151,78
G,1,112530,88,i,56,-32
G,1,112586,80,c,68,-12
G,1,112654,88,h,109,21
G,1,112763,80, ,44,-36
G,1,112807,72,i,80,8
G,1,112887,144,s,100,-44
G,1,112987,60, ,176,116
G,1,113163,100,o,126,26
G,1,113289,35,d,127,92
G,1,113416,80,d,113,33
G,1,113529,55, ,145,90
G,1,113674,95,b,3,-92
G,1,113677,68,e,190,122
G,1,113867,80,c,151,71
G,1,114018,143,a,128,-15
G,1,114146,88,u,5,-83
G,1,114151,131,s,247,116
G,1,114398,108,e,73,-35
G,1,114471,75, ,103,28
G,1,114574,80,t,474,394
G,1,115048,148,o,100,-48
G,1,115148,88,n,35,-53
G,1,115183,109, ,61,-48
G,1,115244,104,t,104,0
G,1,115348,64,h,72,8
G,1,115420,80,e,84,4
G,1,115504,56, ,97,41
G,1,115601,88,w,56,-32
G,1,115657,80,h,128,48
G,1,115785,79,o,152,73
G,1,115937,72,l,98,26
G,1,116035,84,e,44,-40
G,1,116079,72, ,1794,1722
G,1,117873,95,i,160,65
G,1,118033,103,t,87,-16
G,1,118120,72, ,132,60
G,1,118252,63,w,153,90
G,1,118405,112,a,36,-76
G,1,118441,112,s,84,-28
G,1,118525,76,n,429,353
G,1,118954,84,',134,50
G,1,119088,68,t,76,8
G,1,119164,76, ,93,17
G,1,119257,80,t,68,-12
G,1,119325,64,h,96,32
G,1,119421,107,e,51,-56
G,1,119472,68, ,625,557
G,1,120097,80,s,69,-11
G,1,120166,64,m,120,56
G,1,120286,87,a,84,-3
G,1,120370,40,l,116,76
G,1,120486,88,l,200,112
G,1,120686,51, ,660,609
G,1,121346,68,g,219,151
G,1,121565,43,r,142,99
G,1,121707,56,e,128,72
G,1,121835,95,e,43,-52
G,1,121878,52,n,149,97
G,1,122027,47, ,226,179
G,1,122253,43,p,146,103
G,1,122399,97,i,100,3
G,1,122499,88,e,184,96
G,1,122683,115,c,193,78
G,1,122876,96,e,225,129
G,1,123101,92,s,168,76
G,1,123269,76, ,202,126
G,1,123471,75,o,79,4
G,1,123550,96,f,100,4
G,1,123650,56, ,469,413
G,1,124119,87,a,80,-7
G,1,124199,83,p,757,674
G,1,124956,88,p,105,17
G,1,125061,72,a,84,12
G,1,125145,88,p,106,18
G,1,125251,139,e,67,-72
G,1,125318,96,r,100,4
G,1,125418,64, ,214,150
G,1,125632,64,t,72,8
G,1,125704,83,h,136,53
G,1,125840,68,a,136,68
G,1,125976,80,t,76,-4
G,1,126052,52, ,137,85
G,1,126189,116,w,96,-20
G,1,126285,64,e,177,113
G,1,126462,124,r,65,-59
G,1,126527,147,e,59,-88
G,1,126586,60, ,202,142
G,1,126788,124,u,116,-8
G,1,126904,21,n,159,138
G,1,127063,80,h,97,17
G,1,127160,68,a,675,607
G,1,127835,48,p,105,57
G,1,127940,72,p,120,48
G,1,128060,51,y,85,34
G,1,128145,100,.,144,44
G,1,128289,44, ,NA,NA
G,2,80,80,M,144,64
G,2,224,80,y,83,3
G,2,307,57, ,239,182
G,2,546,80,f,180,100
G,2,726,76,a,144,68
G,2,870,55,v,91,36
G,2,961,67,o,96,29
G,2,1057,65,r,82,17
G,2,1139,72,i,80,8
G,2,1219,48,t,144,96
G,2,1363,108,e,100,-8
G,2,1463,44, ,1539,1495
G,2,3002,64,t,167,103
G,2,3169,84,y,64,-20
G,2,3233,72,p,133,61
G,2,3366,84,e,52,-32
G,2,3418,56, ,126,70
G,2,3544,72,o,72,0
G,2,3616,52,f,86,34
G,2,3702,52, ,183,131
G,2,3885,76,f,121,45
G,2,4006,40,o,115,75
G,2,4121,48,o,52,4
G,2,4173,76,d,76,0
G,2,4249,60, ,145,85
G,2,4394,72,i,96,24
G,2,4490,88,s,68,-20
G,2,4558,64, ,465,401
G,2,5023,16,m,119,103
G,2,5142,136,e,112,-24
G,2,5254,64,x,122,58
G,2,5376,80,i,848,768
G,2,6224,112,M,133,21
G,2,6357,144,e,96,-48
G,2,6453,80,x,114,34
G,2,6567,100,i,109,9
G,2,6676,99,c,150,51
G,2,6826,140,a,81,-59
G,2,6907,83,n,102,19
G,2,7009,64, ,225,161
G,2,7234,48,g,106,58
G,2,7340,56,o,127,71
G,2,7467,60,o,792,732
G,2,8259,72,f,80,8
G,2,8339,53,o,111,58
G,2,8450,68,o,90,22
G,2,8540,80,d,122,42
G,2,8662,84,.,96,12
G,2,8758,64, ,975,911
G,2,9733,68,I,223,155
G,2,9956,64, ,299,235
G,2,10255,76,c,24,-52
G,2,10279,116,o,68,-48
G,2,10347,60,u,139,79
G,2,10486,75,l,105,30
G,2,10591,76,d,60,-16
G,2,10651,72, ,118,46
G,2,10769,60,e,155,95
G,2,10924,75,a,163,88
G,2,11087,72,t,52,-20
G,2,11139,75, ,2215,2140
G,2,13354,40,f,153,113
G,2,13507,44,e,126,82
G,2,13633,63,e,48,-15
G,2,13681,71,l,63,-8
G,2,13744,92, ,116,24
G,2,13860,56,l,155,99
G,2,14015,56,i,119,63
G,2,14134,80,k,98,18
G,2,14232,55,e,39,-16
G,2,14271,68, ,423,355
G,2,14694,92,M,150,58
G,2,14844,136,e,100,-36
G,2,14944,108,x,104,-4
G,2,15048,92,i,130,38
G,2,15178,84,c,155,71
G,2,15333,109,a,48,-61
G,2,15381,80,n,80,0
G,2,15461,61, ,183,122
G,2,15644,80,f,92,12
G,2,15736,44,o,108,64
G,2,15844,64,o,93,29
G,2,15937,116,d,48,-68
G,2,15985,76, ,164,88
G,2,16149,81,i,144,63
G,2,16293,68,s,124,56
G,2,16417,53, ,155,102
G,2,16572,84,u,61,-23
G,2,16633,63,s,87,24
G,2,16720,60,u,72,12
G,2,16792,56,a,148,92
G,2,16940,40,l,104,64
G,2,17044,80,l,15,-65
G,2,17059,20,y,163,143
G,2,17222,60, ,85,25
G,2,17307,89,a,57,-32
G,2,17364,56, ,177,121
G,2,17541,52,l,120,68
G,2,17661,84,o,80,-4
G,2,17741,52,t,104,52
G,2,17845,44, ,127,83
G,2,17972,68,o,4,-64
G,2,17976,64,f,135,71
G,2,18111,68, ,53,-15
G,2,18164,92,t,72,-20
G,2,18236,100,h,40,-60
G,2,18276,116,e,133,17
G,2,18409,48, ,108,60
G,2,18517,112,s,68,-44
G,2,18585,112,a,112,0
G,2,18697,52,m,95,43
G,2,18792,68,e,41,-27
G,2,18833,55, ,147,92
G,2,18980,131,i,79,-52
G,2,19059,93,n,154,61
G,2,19213,60,g,314,254
G,2,19527,39,r,322,283
G,2,19849,55,e,295,240
G,2,20144,87,d,229,142
G,2,20373,72,n,468,396
G,2,20841,88,i,127,39
G,2,20968,71,e,83,12
G,2,21051,65,n,65,0
G,2,21116,76,t,177,101
G,2,21293,104,",",4,-100
G,2,21297,73,s,153,80
G,2,21450,73, ,60,-13
G,2,21510,72,b,115,43
G,2,21625,72,u,906,834
G,2,22531,80,s,100,20
G,2,22631,100,",",140,40
G,2,22771,71, ,59,-12
G,2,22830,56,b,121,65
G,2,22951,76,u,84,8
G,2,23035,68,t,60,-8
G,2,23095,64, ,168,104
G,2,23263,65,i,189,124
G,2,23452,64,s,111,47
G,2,23563,48, ,395,347
G,2,23958,95,p,92,-3
G,2,24050,124,r,76,-48
G,2,24126,87,e,149,62
G,2,24275,84,p,41,-43
G,2,24316,67,a,124,57
G,2,24440,84,r,128,44
G,2,24568,160,e,96,-64
G,2,24664,133,d,117,-16
G,2,24781,64, ,630,566
G,2,25411,68,o,117,49
G,2,25528,60,r,112,52
G,2,25640,41, ,518,477
G,2,26158,92,p,132,40
G,2,26290,80,a,107,27
G,2,26397,92,k,92,0
G,2,26489,76,c,133,57
G,2,26622,124,a,170,46
G,2,26792,68,g,197,129
G,2,26989,208,e,152,-56
G,2,27141,116,d,1738,1622
G,2,28879,144,a,104,-40
G,2,28983,72,c,40,-32
G,2,29023,97,k,2588,2491
G,2,31611,201,a,108,-93
G,2,31719,88,c,104,16
G,2,31823,119,k,355,236
G,2,32178,88,a,189,101
G,2,32367,91,g,103,12
G,2,32470,60,e,156,96
G,2,32626,97,d,65,-32
G,2,32691,87, ,215,128
G,2,32906,75,s,71,-4
G,2,32977,153,l,109,-44
G,2,33086,99,i,112,13
G,2,33198,60,g,89,29
G,2,33287,92,h,80,-12
G,2,33367,56,t,108,52
G,2,33475,59,l,53,-6
G,2,33528,76,y,103,27
G,2,33631,72, ,220,148
G,2,33851,68,d,94,26
G,2,33945,80,i,101,21
G,2,34046,24,f,103,79
G,2,34149,68,f,146,78
G,2,34295,120,e,72,-48
G,2,34367,148,r,132,-16
G,2,34499,84,n,4,-80
G,2,34503,76,e,156,80
G,2,34659,58,t,35,-23
G,2,34694,64,l,125,61
G,2,34819,75,y,80,5
G,2,34899,79, ,1627,1548
G,2,36526,90,e,60,-30
G,2,36586,69,n,142,73
G,2,36728,76,t,120,44
G,2,36848,68,l,101,33
G,2,36949,64,y,573,509
G,2,37522,80,",",106,26
G,2,37628,64, ,118,54
G,2,37746,61,b,129,68
G,2,37875,84,u,80,-4
G,2,37955,52,t,90,38
G,2,38045,53, ,140,87
G,2,38185,84,a,88,4
G,2,38273,52,l,110,58
G,2,38383,75,l,75,0
G,2,38458,68, ,99,31
G,2,38557,80,o,83,3
G,2,38640,73,f,98,25
G,2,38738,68, ,142,74
G,2,38880,96,t,28,-68
G,2,38908,76,h,113,37
G,2,39021,80,e,36,-44
G,2,39057,56, ,143,87
G,2,39200,85,b,49,-36
G,2,39249,143,a,76,-67
G,2,39325,91,s,186,95
G,2,39511,87,e,64,-23
G,2,39575,56, ,173,117
G,2,39748,108,i,40,-68
G,2,39788,109,n,227,118
G,2,40015,92,g,80,-12
G,2,40095,128,r,92,-36
G,2,40187,92,e,163,71
G,2,40350,60,d,64,4
G,2,40414,80,i,106,26
G,2,40520,77,e,88,11
G,2,40608,68,n,100,32
G,2,40708,68,t,178,110
G,2,40886,64,s,60,-4
G,2,40946,64, ,128,64
G,2,41074,84,a,242,158
G,2,41316,36,t,381,345
G,2,41697,124,r,104,-20
G,2,41801,112,e,60,-52
G,2,41861,72, ,396,324
G,2,42257,111,p,91,-20
G,2,42348,124,e,68,-56
G,2,42416,88,r,175,87
G,2,42591,60,f,184,124
G,2,42775,116,e,56,-60
G,2,42831,196,c,64,-132
G,2,42895,132,t,185,53
G,2,43080,80,.,1635,1555
G,2,44715,56,I,129,73
G,2,44844,60, ,260,200
G,2,45104,84,l,178,94
G,2,45282,71,o,39,-32
G,2,45321,140,v,112,-28
G,2,45433,80,e,126,46
G,2,45559,28, ,605,577
G,2,46164,84,a,108,24
G,2,46272,72,n,122,50
G,2,46394,68,y,107,39
G,2,46501,60, ,598,538
G,2,47099,64,t,151,87
G,2,47250,76,y,57,-19
G,2,47307,79,p,135,56
G,2,47442,93,e,49,-44
G,2,47491,51, ,122,71
G,2,47613,84,o,64,-20
G,2,47677,72,f,89,17
G,2,47766,64, ,561,497
G,2,48327,72,t,173,101
G,2,48500,136,a,108,-28
G,2,48608,84,c,96,12
G,2,48704,92,o,120,28
G,2,48824,44, ,1980,1936
G,2,50804,72,o,113,41
G,2,50917,69,r,69,0
G,2,50986,81, ,208,127
G,2,51194,104,q,122,18
G,2,51316,87,u,59,-28
G,2,51375,84,e,193,109
G,2,51568,172,s,116,-56
G,2,51684,267,d,53,-214
G,2,51737,154,a,757,603
G,2,52494,144,a,151,7
G,2,52645,69,d,256,187
G,2,52901,52,i,169,117
G,2,53070,36,l,102,66
G,2,53172,80,l,169,89
G,2,53341,116,a,60,-56
G,2,53401,56, ,198,142
G,2,53599,68,o,68,0
G,2,53667,72,r,97,25
G,2,53764,60, ,775,715
G,2,54539,79,b,202,123
G,2,54741,113,u,432,319
G,2,55173,64,r,1035,971
G,2,56208,80,o,156,76
G,2,56364,76,w,88,12
G,2,56452,92,l,129,37
G,2,56581,60, ,4982,4922
G,2,61563,54,.,183,129
G,2,61746,64, ,697,633
G,2,62443,41,u,890,849
G,2,63333,111,T,100,-11
G,2,63433,96,h,96,0
G,2,63529,99,e,76,-23
G,2,63605,156,r,116,-40
G,2,63721,116,e,355,239
G,2,64076,83,',142,59
G,2,64218,96,s,80,-16
G,2,64298,64, ,145,81
G,2,64443,108,u,100,-8
G,2,64543,56,s,342,286
G,2,64885,81,u,102,21
G,2,64987,72,a,126,54
G,2,65113,44,l,98,54
G,2,65211,64,l,52,-12
G,2,65263,57,y,103,46
G,2,65366,80, ,68,-12
G,2,65434,85,t,69,-16
G,2,65503,95,h,103,8
G,2,65606,64,e,68,4
G,2,65674,56, ,724,668
G,2,66398,116,p,100,-16
G,2,66498,128,e,76,-52
G,2,66574,88,r,193,105
G,2,66767,79,f,244,165
G,2,67011,144,e,72,-72
G,2,67083,172,c,88,-84
G,2,67171,96,t,92,-4
G,2,67263,64, ,1852,1788
G,2,69115,88,g,88,0
G,2,69203,112,r,76,-36
G,2,69279,100,e,117,17
G,2,69396,165,a,77,-88
G,2,69473,52,t,2764,2712
G,2,72237,68,c,86,18
G,2,72323,116,o,60,-56
G,2,72383,72,m,185,113
G,2,72568,47,b,154,107
G,2,72722,129,i,77,-52
G,2,72799,80,n,52,-28
G,2,72851,56,a,160,104
G,2,73011,64,t,36,-28
G,2,73047,56,i,161,105
G,2,73208,80,o,45,-35
G,2,73253,72,n,115,43
G,2,73368,72, ,72,0
G,2,73440,71,o,123,52
G,2,73563,76,f,72,-4
G,2,73635,64, ,162,98
G,2,73797,60,a,37,-23
G,2,73834,43, ,191,148
G,2,74025,91,m,63,-28
G,2,74088,92,e,191,99
G,2,74279,56,a,122,66
G,2,74401,80,t,110,30
G,2,74511,40,",",120,80
G,2,74631,45, ,746,701
G,2,75377,63,c,56,-7
G,2,75433,64,h,149,85
G,2,75582,52,e,134,82
G,2,75716,46,e,156,110
G,2,75872,51,s,171,120
G,2,76043,76,e,80,4
G,2,76123,92,",",119,27
G,2,76242,65, ,122,57
G,2,76364,148,a,1652,1504
G,2,78016,108,l,84,-24
G,2,78100,72,e,167,95
G,2,78267,68,t,121,53
G,2,78388,68,t,66,-2
G,2,78454,103,u,154,51
G,2,78608,48,c,167,119
G,2,78775,84,a,819,735
G,2,79594,48,e,729,681
G,2,80323,128,",",116,-12
G,2,80439,48, ,105,57
G,2,80544,144,a,109,-35
G,2,80653,43,n,31,-12
G,2,80684,80,d,121,41
G,2,80805,55, ,117,62
G,2,80922,56,s,73,17
G,2,80995,112,o,48,-64
G,2,81043,104,m,171,67
G,2,81214,95,e,87,-8
G,2,81301,40, ,114,74
G,2,81415,88,o,80,-8
G,2,81495,80,t,84,4
G,2,81579,80,h,68,-12
G,2,81647,116,e,84,-32
G,2,81731,64,r,68,4
G,2,81799,48, ,312,264
G,2,82111,88,v,100,12
G,2,82211,60,e,115,55
G,2,82326,76,e,80,4
G,2,82406,100,g,141,41
G,2,82547,60,a,153,93
G,2,82700,79,t,1020,941
G,2,83720,79,g,164,85
G,2,83884,64,e,417,353
G,2,84301,124,e,81,-43
G,2,84382,99,g,187,88
G,2,84569,100,e,462,362
G,2,85031,56,t,152,96
G,2,85183,96,a,68,-28
G,2,85251,44,b,123,79
G,2,85374,76,l,64,-12
G,2,85438,56,e,6685,6629
G,2,92123,92,b,92,0
G,2,92215,88,e,180,92
G,2,92395,104,a,20,-84
G,2,92415,64,n,215,151
G,2,92630,99,",",96,-3
G,2,92726,83, ,76,-7
G,2,92802,159,a,96,-63
G,2,92898,71,n,79,8
G,2,92977,104,d,84,-20
G,2,93061,73, ,275,202
G,2,93336,32,e,655,623
G,2,93991,80,v,182,102
G,2,94173,84,e,112,28
G,2,94285,72,g,118,46
G,2,94403,88,e,364,276
G,2,94767,67,t,180,113
G,2,94947,84,a,72,-12
G,2,95019,64,b,154,90
G,2,95173,71,l,76,5
G,2,95249,56,e,84,28
G,2,95333,64, ,259,195
G,2,95592,68,w,130,62
G,2,95722,80,h,165,85
G,2,95887,76,i,72,-4
G,2,95959,68,c,93,25
G,2,96052,64,h,64,0
G,2,96116,72, ,809,737
G,2,96925,96,m,145,49
G,2,97070,68,a,85,17
G,2,97155,76,k,103,27
G,2,97258,60,e,137,77
G,2,97395,56, ,475,419
G,2,97870,36,s,58,22
G,2,97928,56, ,153,97
G,2,98081,76,i,93,17
G,2,98174,60,t,132,72
G,2,98306,36, ,755,719
G,2,99061,72, ,1210,1138
G,2,100271,88,a,485,397
G,2,100756,88,m,154,66
G,2,100910,92,o,24,-68
G,2,100934,95,s,158,63
G,2,101092,88,t,52,-36
G,2,101144,80, ,491,411
G,2,101635,72,d,56,-16
G,2,101691,88,i,119,31
G,2,101810,68,s,65,-3
G,2,101875,84,h,111,27
G,2,101986,56,e,142,86
G,2,102128,96,s,51,-45
G,2,102179,68, ,1283,1215
G,2,103462,84,p,95,11
G,2,103557,92,r,110,18
G,2,103667,104,e,190,86
G,2,103857,71,t,143,72
G,2,104000,88,t,177,89
G,2,104177,76,y,80,4
G,2,104257,36, ,515,479
G,2,104772,92,n,198,106
G,2,104970,108,u,159,51
G,2,105129,80,t,198,118
G,2,105327,68,r,1524,1456
G,2,106851,36,u,533,497
G,2,107384,80,i,126,46
G,2,107510,68,t,80,12
G,2,107590,68,i,242,174
G,2,107832,160,o,152,-8
G,2,107984,92,u,180,88
G,2,108164,56,s,204,148
G,2,108368,104,",",137,33
G,2,108505,76, ,156,80
G,2,108661,52,a,194,142
G,2,108855,100,l,126,26
G,2,108981,68,t,85,17
G,2,109066,60,h,134,74
G,2,109200,116,o,72,-44
G,2,109272,96,u,144,48
G,2,109416,64,g,128,64
G,2,109544,32,h,40,8
G,2,109584,129, ,105,-24
G,2,109689,104,t,49,-55
G,2,109738,79,h,164,85
G,2,109902,56,e,44,-12
G,2,109946,57, ,127,70
G,2,110073,55,w,195,140
G,2,110268,111,a,116,5
G,2,110384,80,y,110,30
G,2,110494,112, ,119,7
G,2,110613,116,t,93,-23
G,2,110706,88,h,113,25
G,2,110819,108,e,80,-28
G,2,110899,64, ,13048,12984
G,2,123947,112,y,360,248
G,2,124307,116,',108,-8
G,2,124415,144,r,108,-36
G,2,124523,120,e,32,-88
G,2,124555,92, ,203,111
G,2,124758,119,p,108,-11
G,2,124866,136,r,84,-52
G,2,124950,119,e,108,-11
G,2,125058,84,p,160,76
G,2,125218,64,a,97,33
G,2,125315,112,r,85,-27
G,2,125400,192,e,231,39
G,2,125631,96, ,529,433
G,2,126160,84,d,56,-28
G,2,126216,76, ,407,331
G,2,126623,79,d,64,-15
G,2,126687,88,o,114,26
G,2,126801,68,e,150,82
G,2,126951,103,s,84,-19
G,2,127035,52,n,418,366
G,2,127453,104,',132,28
G,2,127585,68,t,80,12
G,2,127665,72, ,1199,1127
G,2,128864,88,u,121,33
G,2,128985,84,s,72,-12
G,2,129057,68,u,103,35
G,2,129160,88,a,132,44
G,2,129292,44,l,114,70
G,2,129406,72,;,75,3
G,2,129481,69,y,118,49
G,2,129599,72, ,2098,2026
G,2,131697,80,m,100,20
G,2,131797,80,a,60,-20
G,2,131857,100,k,92,-8
G,2,131949,72,e,93,21
G,2,132042,60, ,68,8
G,2,132110,152,t,48,-104
G,2,132158,93,h,136,43
G,2,132294,92,e,115,23
G,2,132409,84,m,462,378
G,2,132871,64, ,173,109
G,2,133044,96,t,72,-24
G,2,133116,77,h,88,11
G,2,133204,93,e,48,-45
G,2,133252,86, ,233,147
G,2,133485,23,h,57,34
G,2,133542,68,e,167,99
G,2,133709,95,a,118,23
G,2,133827,44,l,515,471
G,2,134342,80,h,136,56
G,2,134478,68,t,495,427
G,2,134973,72,t,40,-32
G,2,135013,84,h,165,81
G,2,135178,97,i,118,21
G,2,135296,64,e,151,87
G,2,135447,80,s,194,114
G,2,135641,76,t,4,-72
G,2,135645,61, ,167,106
G,2,135812,60,o,143,83
G,2,135955,88,p,126,38
G,2,136081,56,t,77,21
G,2,136158,44,i,125,81
G,2,136283,80,o,48,-32
G,2,136331,56,n,165,109
G,2,136496,53,",",100,47
G,2,136596,48, ,772,724
G,2,137368,80,.,127,47
G,2,137495,44, ,NA,NA
H,1,0,169,f,22491,22322
H,1,22491,175,F,274,99
H,1,22765,176,a,224,48
H,1,22989,152,r,197,45
H,1,23186,96, ,211,115
H,1,23397,72,o,188,116
H,1,23585,63,u,56,-7
H,1,23641,119,t,120,1
H,1,23761,56, ,117,61
H,1,23878,125,i,101,-24
H,1,23979,72,n,138,66
H,1,24117,90, ,89,-1
H,1,24206,88,t,99,11
H,1,24305,85,h,89,4
H,1,24394,92,e,130,38
H,1,24524,30, ,153,123
H,1,24677,128,u,76,-52
H,1,24753,116,n,124,8
H,1,24877,96,c,203,107
H,1,25080,133,h,147,14
H,1,25227,157,a,145,-12
H,1,25372,81,t,922,841
H,1,26294,128,r,108,-20
H,1,26402,169,t,153,-16
H,1,26555,112,e,15,-97
H,1,26570,58,r,201,143
H,1,26771,136,d,206,70
H,1,26977,148, ,2900,2752
H,1,29877,136,d,162,26
H,1,30039,125, ,328,203
H,1,30367,111,b,68,-43
H,1,30435,148,a,91,-57
H,1,30526,133,c,117,-16
H,1,30643,120,k,198,78
H,1,30841,104,w,174,70
H,1,31015,129,a,154,25
H,1,31169,88,t,117,29
H,1,31286,152,e,107,-45
H,1,31393,124,r,124,0
H,1,31517,152,s,177,25
H,1,31694,81, ,197,116
H,1,31891,68,o,44,-24
H,1,31935,117,f,147,30
H,1,32082,73, ,126,53
H,1,32208,75,t,74,-1
H,1,32282,87,h,113,26
H,1,32395,145,e,85,-60
H,1,32480,67, ,197,130
H,1,32677,107,u,63,-44
H,1,32740,116,n,335,219
H,1,33075,113,f,153,40
H,1,33228,147,a,345,198
H,1,33573,132,s,225,93
H,1,33798,88,h,221,133
H,1,34019,51,i,1297,1246
H,1,35316,43,n,110,67
H,1,35426,112,a,1511,1399
H,1,36937,118,o,135,17
H,1,37072,104,n,163,59
H,1,37235,124,a,53,-71
H,1,37288,75,b,162,87
H,1,37450,65,l,84,19
H,1,37534,120,e,76,-44
H,1,37610,95, ,786,691
H,1,38396,95,e,84,-11
H,1,38480,63,n,108,45
H,1,38588,129,d,49,-80
H,1,38637,87, ,165,78
H,1,38802,60,o,95,35
H,1,38897,88,f,73,-15
H,1,38970,72, ,136,64
H,1,39106,81,t,45,-36
H,1,39151,71,h,142,71
H,1,39293,100,e,35,-65
H,1,39328,112, ,211,99
H,1,39539,167,w,419,252
H,1,39958,147,e,124,-23
H,1,40082,111,s,112,1
H,1,40194,99,t,139,40
H,1,40333,143,e,112,-31
H,1,40445,169,r,168,-1
H,1,40613,181,n,210,29
H,1,40823,136, ,331,195
H,1,41154,103,s,143,40
H,1,41297,77,p,115,38
H,1,41412,69,e,103,34
H,1,41515,85,i,756,671
H,1,42271,57,i,76,19
H,1,42347,105,r,127,22
H,1,42474,129,a,69,-60
H,1,42543,87,l,192,105
H,1,42735,117, ,336,219
H,1,43071,120,a,336,216
H,1,43407,47,m,104,57
H,1,43511,137,r,508,371
H,1,44019,147,r,124,-23
H,1,44143,83,m,154,71
H,1,44297,104, ,202,98
H,1,44499,71,o,67,-4
H,1,44566,109,f,116,7
H,1,44682,84, ,157,73
H,1,44839,76,t,57,-19
H,1,44896,83,h,134,51
H,1,45030,129,e,72,-57
H,1,45102,76, ,580,504
H,1,45682,91,F,539,448
H,1,46221,75,G,94,19
H,1,46315,89,l,105,16
H,1,46420,164,a,301,137
H,1,46721,43,a,597,554
H,1,47318,108,a,173,65
H,1,47491,92,l,27,-65
H,1,47518,125,a,338,213
H,1,47856,140,z,215,75
H,1,48071,147,a,204,57
H,1,48275,83,t,1667,1584
H,1,49942,112,x,189,77
H,1,50131,89,y,179,90
H,1,50310,104, ,1182,1078
H,1,51492,68,l,222,154
H,1,51714,93,i,92,-1
H,1,51806,200,e,127,-73
H,1,51933,107,s,16,-91
H,1,51949,86, ,194,108
H,1,52143,81,i,57,-24
H,1,52200,92,n,162,70
H,1,52362,88, ,815,727
H,1,53177,131,a,97,-34
H,1,53274,107, ,308,201
H,1,53582,64,m,435,371
H,1,54017,104,s,120,16
H,1,54137,72,m,116,44
H,1,54253,124,a,52,-72
H,1,54305,52,l,654,602
H,1,54959,52,l,206,154
H,1,55165,129, ,684,555
H,1,55849,102,u,25,-77
H,1,55874,149,n,240,91
H,1,56114,153,r,101,-52
H,1,56215,127,e,220,93
H,1,56435,141,g,211,70
H,1,56646,172,a,743,571
H,1,57389,180,r,638,458
H,1,58027,102,d,187,85
H,1,58214,117,e,194,77
H,1,58408,140,d,180,40
H,1,58588,114, ,476,362
H,1,59064,112,u,130,18
H,1,59194,150,e,822,672
H,1,60016,56,y,85,29
H,1,60101,131,e,166,35
H,1,60267,57,l,144,87
H,1,60411,81,l,198,117
H,1,60609,85,o,80,-5
H,1,60689,120,w,183,63
H,1,60872,104, ,3487,3383
H,1,64359,125,s,265,140
H,1,64624,96,u,31,-65
H,1,64655,94,n,340,246
H,1,64995,64,.,166,102
H,1,65161,64, ,2180,2116
H,1,67341,59,O,114,55
H,1,67455,129,r,266,137
H,1,67721,87,b,151,64
H,1,67872,117,i,205,88
H,1,68077,89,t,20,-69
H,1,68097,141,i,88,-53
H,1,68185,128,n,113,-15
H,1,68298,135,g,99,-36
H,1,68397,132, ,730,598
H,1,69127,92,t,190,98
H,1,69317,112,h,137,25
H,1,69454,71,i,48,-23
H,1,69502,100,s,104,4
H,1,69606,88, ,105,17
H,1,69711,149,a,150,1
H,1,69861,118,t,111,-7
H,1,69972,100, ,173,73
H,1,70145,117,a,165,48
H,1,70310,113, ,468,355
H,1,70778,176,s,480,304
H,1,71258,120,i,71,-49
H,1,71329,108,t,212,104
H,1,71541,111,a,1207,1096
H,1,72748,80,d,87,7
H,1,72835,90,i,85,-5
H,1,72920,105,s,140,35
H,1,73060,108,t,92,-16
H,1,73152,139,a,108,-31
H,1,73260,100,n,107,7
H,1,73367,142,c,78,-64
H,1,73445,119,e,159,40
H,1,73604,104, ,606,502
H,1,74210,76,p,96,20
H,1,74306,88,f,162,74
H,1,74468,97, ,152,55
H,1,74620,137,r,100,-37
H,1,74720,52,p,57,5
H,1,74777,15,o,129,114
H,1,74906,73,u,85,12
H,1,74991,92,g,93,1
H,1,75084,98,h,252,154
H,1,75336,96,l,106,10
H,1,75442,89,y,113,24
H,1,75555,110, ,4176,4066
H,1,79731,72,o,268,196
H,1,79999,96,d,2736,2640
H,1,82735,103,n,727,624
H,1,83462,138, ,238,100
H,1,83700,145,n,189,44
H,1,83889,148,i,1530,1382
H,1,85419,120,n,207,87
H,1,85626,111,e,206,95
H,1,85832,144,t,401,257
H,1,86233,133,y,997,864
H,1,87230,166,t,104,-62
H,1,87334,136,w,61,-75
H,1,87395,107,o,266,159
H,1,87661,119, ,678,559
H,1,88339,136,m,198,62
H,1,88537,94,i,191,97
H,1,88728,76,l,155,79
H,1,88883,85,l,240,155
H,1,89123,117,o,667,550
H,1,89790,132,i,147,15
H,1,89937,137,o,145,8
H,1,90082,108,n,219,111
H,1,90301,141, ,243,102
H,1,90544,81,m,127,46
H,1,90671,91,i,209,118
H,1,90880,52,l,149,97
H,1,91029,29,l,477,448
H,1,91506,160,e,92,-68
H,1,91598,139,s,180,41
H,1,91778,91, ,484,393
H,1,92262,80,i,127,47
H,1,92389,96,s,56,-40
H,1,92445,67, ,185,118
H,1,92630,140,a,75,-65
H,1,92705,89,n,160,71
H,1,92865,45, ,184,139
H,1,93049,88,u,114,26
H,1,93163,88,t,184,96
H,1,93347,108,t,152,44
H,1,93499,149,e,490,341
H,1,93989,103,r,228,125
H,1,94217,111,l,80,-31
H,1,94297,107,y,179,72
H,1,94476,101, ,488,387
H,1,94964,124,i,170,46
H,1,95134,136,s,211,75
H,1,95345,56,n,1210,1154
H,1,96555,72,n,101,29
H,1,96656,78,s,142,64
H,1,96798,95,i,84,-11
H,1,96882,108,g,112,4
H,1,96994,104,n,1547,1443
H,1,98541,112,i,1110,998
H,1,99651,72,f,110,38
H,1,99761,92,i,89,-3
H,1,99850,105,c,23,-82
H,1,99873,160,a,144,-16
H,1,100017,93,n,100,7
H,1,100117,140,t,121,-19
H,1,100238,105, ,498,393
H,1,100736,100,l,216,116
H,1,100952,47,i,14,-33
H,1,100966,69,t,173,104
H,1,101139,109,t,129,20
H,1,101268,100,l,104,4
H,1,101372,132,e,104,-28
H,1,101476,100, ,341,241
H,1,101817,123,b,104,-19
H,1,101921,119,l,213,94
H,1,102134,112,u,141,29
H,1,102275,88,e,289,201
H,1,102564,104, ,376,272
H,1,102940,120,f,244,124
H,1,103184,116,r,146,30
H,1,103330,102,e,187,85
H,1,103517,152,e,121,-31
H,1,103638,112,n,144,32
H,1,103782,132, ,290,158
H,1,104072,178,p,127,-51
H,1,104199,136,l,111,-25
H,1,104310,149,a,192,43
H,1,104502,133,n,77,-56
H,1,104579,147,e,123,-24
H,1,104702,129,t,203,74
H,1,104905,133, ,552,419
H,1,105457,48,s,67,19
H,1,105524,93,h,2056,1963
H,1,107580,65,g,1178,1113
H,1,108758,145,t,473,328
H,1,109231,144,g,712,568
H,1,109943,120,g,67,-53
H,1,110010,119,t,499,380
H,1,110509,126,g,89,-37
H,1,110598,110,r,662,552
H,1,111260,143,r,5113,4970
H,1,116373,145,w,156,11
H,1,116529,84,h,172,88
H,1,116701,109,o,68,-41
H,1,116769,181,s,116,-65
H,1,116885,153,e,5280,5127
H,1,122165,135, ,274,139
H,1,122439,141,a,680,539
H,1,123119,188,e,1184,996
H,1,124303,119,p,99,-20
H,1,124402,161,e,1088,927
H,1,125490,141,d,85,-56
H,1,125575,107,e,207,100
H,1,125782,126,s,115,-11
H,1,125897,131,c,195,64
H,1,126092,123,e,138,15
H,1,126230,118,n,125,7
H,1,126355,56,c,281,225
H,1,126636,141,d,104,-37
H,1,126740,163,e,144,-19
H,1,126884,128,d,202,74
H,1,127086,128, ,672,544
H,1,127758,37,;,1,-36
H,1,127759,56,l,154,98
H,1,127913,77,o,97,20
H,1,128010,132,f,104,-28
H,1,128114,116,e,1307,1191
H,1,129421,64,l,167,103
H,1,129588,92,i,91,-1
H,1,129679,125,f,62,-63
H,1,129741,102,e,132,30
H,1,129873,108, ,257,149
H,1,130130,104,f,108,4
H,1,130238,72,o,237,165
H,1,130475,84,m,531,447
H,1,131006,121,r,81,-40
H,1,131087,95,m,155,60
H,1,131242,136, ,434,298
H,1,131676,101,s,135,34
H,1,131811,92, ,60,-32
H,1,131871,139,a,124,-15
H,1,131995,160,r,80,-80
H,1,132075,140,e,81,-59
H,1,132156,102, ,168,66
H,1,132324,129,s,100,-29
H,1,132424,76,o,179,103
H,1,132603,100, ,270,170
H,1,132873,143,a,120,-23
H,1,132993,100,m,119,19
H,1,133112,184,a,250,66
H,1,133362,80,i,162,82
H,1,133524,123,z,198,75
H,1,133722,126,n,119,-7
H,1,133841,112,g,140,28
H,1,133981,76,l,92,16
H,1,134073,97,y,89,-8
H,1,134162,112, ,2303,2191
H,1,136465,144,s,473,329
H,1,136938,172,z,133,-39
H,1,137071,144,i,87,-57
H,1,137158,85,n,2105,2020
H,1,139263,80,p,129,49
H,1,139392,92,r,97,5
H,1,139489,135,i,115,-20
H,1,139604,117,m,168,51
H,1,139772,140,i,116,-24
H,1,139888,128,t,405,277
H,1,140293,127,i,73,-54
H,1,140366,183,v,106,-77
H,1,140472,140,e,195,55
H,1,140667,120, ,888,768
H,1,141555,83,t,75,-8
H,1,141630,80,h,68,-12
H,1,141698,136,a,89,-47
H,1,141787,108,t,45,-63
H,1,141832,82, ,155,73
H,1,141987,107,t,92,-15
H,1,142079,72,h,84,12
H,1,142163,148,e,104,-44
H,1,142267,92,y,201,109
H,1,142468,81, ,100,19
H,1,142568,164,s,120,-44
H,1,142688,117,t,72,-45
H,1,142760,56,i,203,147
H,1,142963,38,;,149,111
H,1,143112,103,l,1,-102
H,1,143113,103,;,1255,1152
H,1,144368,79,;,26,-53
H,1,144394,30,l,927,897
H,1,145321,84,l,174,90
H,1,145495,72,l,177,105
H,1,145672,121, ,2156,2035
H,1,147828,144,t,179,35
H,1,148007,120,i,1854,1734
H,1,149861,112,h,187,75
H,1,150048,87,i,68,-19
H,1,150116,120,n,158,38
H,1,150274,115,k,241,126
H,1,150515,104, ,597,493
H,1,151112,127,d,128,1
H,1,151240,111,i,123,12
H,1,151363,119,g,104,-15
H,1,151467,112,i,192,80
H,1,151659,113,t,160,47
H,1,151819,173,a,173,0
H,1,151992,103,l,223,120
H,1,152215,116, ,459,343
H,1,152674,56,w,265,209
H,1,152939,164,a,180,16
H,1,153119,113,t,253,140
H,1,153372,125,c,132,7
H,1,153504,101,h,124,23
H,1,153628,169,e,81,-88
H,1,153709,128,s,199,71
H,1,153908,129, ,265,136
H,1,154173,155,a,145,-10
H,1,154318,187,r,120,-67
H,1,154438,163,e,159,-4
H,1,154597,124, ,116,-8
H,1,154713,156,a,172,16
H,1,154885,129, ,306,177
H,1,155191,168,p,164,-4
H,1,155355,147,r,116,-31
H,1,155471,164,e,204,40
H,1,155675,93,t,170,77
H,1,155845,124,t,116,-8
H,1,155961,101,y,153,52
H,1,156114,100, ,210,110
H,1,156324,127,n,103,-24
H,1,156427,154,e,81,-73
H,1,156508,195,a,124,-71
H,1,156632,167,t,256,89
H,1,156888,103, ,231,128
H,1,157119,140,i,262,122
H,1,157381,101,d,180,79
H,1,157561,252,e,116,-136
H,1,157677,200,a,1459,1259
H,1,159136,105, ,229,124
H,1,159365,97, ,361,264
H,1,159726,104,u,115,11
H,1,159841,101,d,154,53
H,1,159995,216,e,112,-104
H,1,160107,156,a,1801,1645
H,1,161908,83,i,31,-52
H,1,161939,177,d,104,-73
H,1,162043,154,e,29,-125
H,1,162072,212,a,213,1
H,1,162285,124,.,2711,2587
H,1,164996,112,T,64,-48
H,1,165060,64,h,107,43
H,1,165167,65,o,4,-61
H,1,165171,72,i,113,41
H,1,165284,141,s,4128,3987
H,1,169412,92,i,113,21
H,1,169525,125,s,85,-40
H,1,169610,63, ,168,105
H,1,169778,155,p,100,-55
H,1,169878,94,l,45,-49
H,1,169923,168,a,163,-5
H,1,170086,136,e,154,18
H,1,170240,96,n,77,-19
H,1,170317,144,t,1480,1336
H,1,171797,72,n,92,20
H,1,171889,140,e,55,-85
H,1,171944,128,t,653,525
H,1,172597,89, ,339,250
H,1,172936,92, ,332,240
H,1,173268,107,h,91,-16
H,1,173359,196,a,124,-72
H,1,173483,168,d,1250,1082
H,1,174733,72, ,157,85
H,1,174890,81, ,620,539
H,1,175510,117,h,62,-55
H,1,175572,187,a,99,-88
H,1,175671,136,s,156,20
H,1,175827,97, ,1567,1470
H,1,177394,75,",",180,105
H,1,177574,67, ,162,95
H,1,177736,75,o,60,-15
H,1,177796,127,r,125,-2
H,1,177921,91, ,221,130
H,1,178142,85,t,113,28
H,1,178255,151,a,136,-15
H,1,178391,124,t,947,823
H,1,179338,160,r,104,-56
H,1,179442,144,a,141,-3
H,1,179583,96,t,43,-53
H,1,179626,87,h,134,47
H,1,179760,168,e,85,-83
H,1,179845,139,r,581,442
H,1,180426,80, ,320,240
H,1,180746,116, ,1058,942
H,1,181804,60, ,135,75
H,1,181939,128, ,385,257
H,1,182324,128,h,75,-53
H,1,182399,177,a,93,-84
H,1,182492,175,d,289,114
H,1,182781,47, ,952,905
H,1,183733,65,",",126,61
H,1,183859,77, ,114,37
H,1,183973,122,a,45,-77
H,1,184018,124, ,280,156
H,1,184298,78,p,71,-7
H,1,184369,147,r,128,-19
H,1,184497,108,o,156,48
H,1,184653,115,b,112,-3
H,1,184765,95,l,132,37
H,1,184897,133,e,85,-48
H,1,184982,137,m,169,32
H,1,185151,134, ,1328,1194
H,1,186479,77,",",169,92
H,1,186648,73, ,76,3
H,1,186724,104,w,128,24
H,1,186852,112,h,104,-8
H,1,186956,101,i,28,-73
H,1,186984,147,c,176,29
H,1,187160,84,h,209,125
H,1,187369,124, ,184,60
H,1,187553,114,w,205,91
H,1,187758,117,a,56,-61
H,1,187814,132,s,145,13
H,1,187959,92, ,129,37
H,1,188088,108,t,90,-18
H,1,188178,127,h,658,531
H,1,188836,90, ,238,148
H,1,189074,72, ,310,238
H,1,189384,125,t,112,-13
H,1,189496,128,h,89,-39
H,1,189585,119,i,91,-28
H,1,189676,144,s,156,12
H,1,189832,128, ,1278,1150
H,1,191110,93,:,234,141
H,1,191344,71, ,187,116
H,1,191531,91,m,130,39
H,1,191661,93,o,47,-46
H,1,191708,156,s,120,-36
H,1,191828,81,t,65,-16
H,1,191893,64, ,155,91
H,1,192048,72,o,28,-44
H,1,192076,107,f,131,24
H,1,192207,64, ,82,18
H,1,192289,93,t,88,-5
H,1,192377,85,h,84,-1
H,1,192461,128,e,101,-27
H,1,192562,79, ,233,154
H,1,192795,120,p,169,49
H,1,192964,116,e,64,-52
H,1,193028,91,o,136,45
H,1,193164,168,p,112,-56
H,1,193276,132,l,139,7
H,1,193415,141,e,130,-11
H,1,193545,67, ,143,76
H,1,193688,104,o,129,25
H,1,193817,104,n,161,57
H,1,193978,85, ,142,57
H,1,194120,73,t,4,-69
H,1,194124,86,i,191,105
H,1,194315,130, ,347,217
H,1,194662,115,w,76,-39
H,1,194738,116,e,109,-7
H,1,194847,163,r,95,-68
H,1,194942,136,e,1417,1281
H,1,196359,67,i,31,-36
H,1,196390,125,t,173,48
H,1,196563,133, ,132,-1
H,1,196695,144,w,80,-64
H,1,196775,107,e,83,-24
H,1,196858,194,r,104,-90
H,1,196962,137,e,154,17
H,1,197116,77, ,631,554
H,1,197747,123,u,72,-51
H,1,197819,115,n,315,200
H,1,198134,92,h,80,-12
H,1,198214,124,a,147,23
H,1,198361,68,p,149,81
H,1,198510,77,p,80,3
H,1,198590,96,y,164,68
H,1,198754,121, ,705,584
H,1,199459,108,f,135,27
H,1,199594,76,o,77,1
H,1,199671,99,r,124,25
H,1,199795,80, ,205,125
H,1,200000,64,p,125,61
H,1,200125,149,r,109,-40
H,1,200234,139,e,196,57
H,1,200430,109,t,200,91
H,1,200630,96,t,189,93
H,1,200819,97,y,123,26
H,1,200942,93, ,230,137
H,1,201172,100,m,201,101
H,1,201373,104,u,45,-59
H,1,201418,122,c,167,45
H,1,201585,96,h,215,119
H,1,201800,79, ,171,92
H,1,201971,76,o,96,20
H,1,202067,69,f,93,24
H,1,202160,73, ,100,27
H,1,202260,116,t,92,-24
H,1,202352,80,h,187,107
H,1,202539,76, ,543,467
H,1,203082,125,e,153,28
H,1,203235,79, ,115,36
H,1,203350,116,t,96,-20
H,1,203446,144,i,68,-76
H,1,203514,120,m,111,-9
H,1,203625,161,e,164,3
H,1,203789,125, ,569,444
H,1,204358,81,.,195,114
H,1,204553,76, ,197,121
H,1,204750,94,M,147,53
H,1,204897,146,a,97,-49
H,1,204994,92,n,138,46
H,1,205132,107,y,85,-22
H,1,205217,116, ,308,192
H,1,205525,144,s,333,189
H,1,205858,53,l,1128,1075
H,1,206986,60,o,131,71
H,1,207117,92,l,214,122
H,1,207331,68,u,32,-36
H,1,207363,107,t,158,51
H,1,207521,68,i,56,-12
H,1,207577,188,o,128,-60
H,1,207705,156,n,273,117
H,1,207978,141, ,1136,995
H,1,209114,124,s,128,4
H,1,209242,104, ,758,654
H,1,210000,124,w,61,-63
H,1,210061,111,e,78,-33
H,1,210139,188,r,96,-92
H,1,210235,160,e,113,-47
H,1,210348,112, ,366,254
H,1,210714,136,s,182,46
H,1,210896,97,u,73,-24
H,1,210969,96,g,187,91
H,1,211156,173,e,225,52
H,1,211381,129,s,655,526
H,1,212036,132,s,155,23
H,1,212191,144,t,122,-22
H,1,212313,146,e,240,94
H,1,212553,164,d,2601,2437
H,1,215154,124,g,237,113
H,1,215391,209,e,125,-84
H,1,215516,159,s,132,-27
H,1,215648,135,t,112,-23
H,1,215760,127,e,220,93
H,1,215980,126,d,520,394
H,1,216500,112, ,385,273
H,1,216885,108,f,111,3
H,1,216996,92,o,84,-8
H,1,217080,104,r,137,33
H,1,217217,56, ,49,-7
H,1,217266,99,t,104,5
H,1,217370,107,h,108,1
H,1,217478,62,i,35,-27
H,1,217513,109,s,116,7
H,1,217629,76, ,184,108
H,1,217813,96,p,93,-3
H,1,217906,124,r,127,3
H,1,218033,76,o,138,62
H,1,218171,88,b,107,19
H,1,218278,65,l,142,77
H,1,218420,144,e,52,-92
H,1,218472,81,m,227,146
H,1,218699,101,",",174,73
H,1,218873,113, ,567,454
H,1,219440,68,b,102,34
H,1,219542,139,u,125,-14
H,1,219667,110,t,64,-46
H,1,219731,103, ,358,255
H,1,220089,100,m,132,32
H,1,220221,156,o,72,-84
H,1,220293,168,s,140,-28
H,1,220433,103,t,89,-14
H,1,220522,70, ,160,90
H,1,220682,88,o,19,-69
H,1,220701,112,f,184,72
H,1,220885,76, ,66,-10
H,1,220951,90,t,141,51
H,1,221092,104,h,61,-43
H,1,221153,111,e,123,12
H,1,221276,196,s,104,-92
H,1,221380,165,e,172,7
H,1,221552,98, ,96,-2
H,1,221648,125,w,53,-72
H,1,221701,123,e,111,-12
H,1,221812,157,r,100,-57
H,1,221912,165,e,166,1
H,1,222078,99, ,219,120
H,1,222297,96,l,61,-35
H,1,222358,147,a,108,-39
H,1,222466,139,r,162,23
H,1,222628,148,g,339,191
H,1,222967,131,l,80,-51
H,1,223047,63,y,421,358
H,1,223468,85, ,2401,2316
H,1,225869,158,e,2515,2357
H,1,228384,160,e,1911,1751
H,1,230295,126, ,275,149
H,1,230570,123,c,120,-3
H,1,230690,112,o,131,19
H,1,230821,88,n,31,-57
H,1,230852,113,c,173,60
H,1,231025,139,e,103,-36
H,1,231128,147,r,128,-19
H,1,231256,160,e,28,-132
H,1,231284,85,n,337,252
H,1,231621,156,c,870,714
H,1,232491,88,n,48,-40
H,1,232539,132,e,230,98
H,1,232769,177,c,656,479
H,1,233425,140,d,200,60
H,1,233625,93, ,194,101
H,1,233819,122,w,116,-6
H,1,233935,111,i,127,16
H,1,234062,120,t,105,-15
H,1,234167,80,h,180,100
H,1,234347,76, ,116,40
H,1,234463,111,t,80,-31
H,1,234543,72,h,114,42
H,1,234657,139,e,67,-72
H,1,234724,65, ,162,97
H,1,234886,84,m,106,22
H,1,234992,128,o,209,81
H,1,235201,147,v,64,-83
H,1,235265,115,e,162,47
H,1,235427,85,m,89,4
H,1,235516,131,e,123,-8
H,1,235639,113,n,200,87
H,1,235839,226,t,196,-30
H,1,236035,156,s,164,8
H,1,236199,72, ,181,109
H,1,236380,88,o,65,-23
H,1,236445,123,f,139,16
H,1,236584,69, ,85,16
H,1,236669,111,s,92,-19
H,1,236761,108,m,132,24
H,1,236893,132,a,104,-28
H,1,236997,76,l,170,94
H,1,237167,64,l,162,98
H,1,237329,106, ,132,26
H,1,237461,100,g,231,131
H,1,237692,106,r,111,5
H,1,237803,120,e,212,92
H,1,238015,140,e,156,16
H,1,238171,128,n,144,16
H,1,238315,165, ,309,144
H,1,238624,104,p,107,3
H,1,238731,117,e,124,7
H,1,238855,109,i,134,25
H,1,238989,172,c,41,-131
H,1,239030,219,e,2426,2207
H,1,241456,112,i,114,2
H,1,241570,93,e,104,11
H,1,241674,169,c,105,-64
H,1,241779,112,e,418,306
H,1,242197,136,s,287,151
H,1,242484,84, ,183,99
H,1,242667,69,o,92,23
H,1,242759,76,f,72,-4
H,1,242831,55, ,153,98
H,1,242984,61,p,77,16
H,1,243061,120,a,87,-33
H,1,243148,145,p,150,5
H,1,243298,164,e,115,-49
H,1,243413,144,r,208,64
H,1,243621,137, ,876,739
H,1,244497,89,m,1367,1278
H,1,245864,68,",",151,83
H,1,246015,76, ,122,46
H,1,246137,140,w,183,43
H,1,246320,100,h,133,33
H,1,246453,129,i,84,-45
H,1,246537,109,c,135,26
H,1,246672,101,h,226,125
H,1,246898,108, ,2175,2067
H,1,249073,68, ,282,214
H,1,249355,104,o,1199,1095
H,1,250554,43,i,670,627
H,1,251224,72,i,107,35
H,1,251331,136,s,113,-23
H,1,251444,80, ,209,129
H,1,251653,92,o,142,50
H,1,251795,104,f,184,80
H,1,251979,152,f,758,606
H,1,252737,100,d,190,90
H,1,252927,129,d,185,56
H,1,253112,132,",",251,119
H,1,253363,130, ,524,394
H,1,253887,84,b,65,-19
H,1,253952,108,e,132,24
H,1,254084,149,c,85,-64
H,1,254169,131,a,111,-20
H,1,254280,124,u,105,-19
H,1,254385,163,s,95,-68
H,1,254480,144,e,56,-88
H,1,254536,77, ,188,111
H,1,254724,79,o,91,12
H,1,254815,140,f,112,-28
H,1,254927,76, ,723,647
H,1,255650,75,n,162,87
H,1,255812,68, ,97,29
H,1,255909,104,t,97,-7
H,1,256006,63,h,111,48
H,1,256117,103,e,64,-39
H,1,256181,72, ,115,43
H,1,256296,153,w,116,-37
H,1,256412,89,h,180,91
H,1,256592,81,o,203,122
H,1,256795,103,l,96,-7
H,1,256891,136,e,177,41
H,1,257068,80, ,147,67
H,1,257215,105,i,46,-59
H,1,257261,143,t,586,443
H,1,257847,65, ,70,5
H,1,257917,127,w,186,59
H,1,258103,164,a,73,-91
H,1,258176,151,s,84,-67
H,1,258260,59,n,248,189
H,1,258508,81,;,88,7
H,1,258596,143,t,245,102
H,1,258841,56, ,957,901
H,1,259798,103,',115,12
H,1,259913,105,t,144,39
H,1,260057,86, ,119,33
H,1,260176,117,t,124,7
H,1,260300,80,h,107,27
H,1,260407,133,e,73,-60
H,1,260480,88, ,196,108
H,1,260676,129,s,175,46
H,1,260851,76,m,28,-48
H,1,260879,133,a,593,460
H,1,261472,82,l,152,70
H,1,261624,85,l,97,12
H,1,261721,132,e,892,760
H,1,262613,56, ,384,328
H,1,262997,55,g,365,310
H,1,263362,100,r,190,90
H,1,263552,93,e,183,90
H,1,263735,140,e,125,-15
H,1,263860,124,n,153,29
H,1,264013,113, ,238,125
H,1,264251,83,p,215,132
H,1,264466,89,i,447,358
H,1,264913,177,e,184,7
H,1,265097,144,c,104,-40
H,1,265201,132,e,357,225
H,1,265558,88,s,137,49
H,1,265695,88, ,254,166
H,1,265949,49,o,799,750
H,1,266748,120,f,194,74
H,1,266942,112, ,386,274
H,1,267328,91,p,167,76
H,1,267495,128,a,98,-30
H,1,267593,99,p,155,56
H,1,267748,176,e,113,-63
H,1,267861,131,r,270,139
H,1,268131,85,t,753,668
H,1,268884,68, ,96,28
H,1,268980,105,t,130,25
H,1,269110,64,h,24,-40
H,1,269134,144,a,217,73
H,1,269351,144, ,362,218
H,1,269713,117,w,581,464
H,1,270294,117,t,163,46
H,1,270457,72, ,126,54
H,1,270583,145,w,100,-45
H,1,270683,108,e,84,-24
H,1,270767,173,r,92,-81
H,1,270859,160,e,136,-24
H,1,270995,116, ,349,233
H,1,271344,143,u,67,-76
H,1,271411,127,n,322,195
H,1,271733,88,h,81,-7
H,1,271814,135,a,132,-3
H,1,271946,64,p,140,76
H,1,272086,72,p,105,33
H,1,272191,125,y,118,-7
H,1,272309,116,.,NA,NA
H,2,728,103,M,170,67
H,2,898,115,y,63,-52
H,2,961,116, ,741,625
H,2,1702,143,f,120,-23
H,2,1822,147,a,170,23
H,2,1992,108,v,162,54
H,2,2154,97,o,132,35
H,2,2286,136,t,1056,920
H,2,3342,77,r,132,55
H,2,3474,65,i,994,929
H,2,4468,197,t,132,-65
H,2,4600,157,e,109,-48
H,2,4709,132, ,1325,1193
H,2,6034,115,m,79,-36
H,2,6113,164,e,96,-68
H,2,6209,168,a,88,-80
H,2,6297,72,l,195,123
H,2,6492,88, ,840,752
H,2,7332,65,n,165,100
H,2,7497,104,o,262,158
H,2,7759,141,w,744,603
H,2,8503,134,a,445,311
H,2,8948,163,d,126,-37
H,2,9074,150,a,78,-72
H,2,9152,96,y,213,117
H,2,9365,195,s,112,-83
H,2,9477,72,",",153,81
H,2,9630,140, ,1582,1442
H,2,11212,85, ,209,124
H,2,11421,76,h,94,18
H,2,11515,169,a,109,-60
H,2,11624,128,s,60,-68
H,2,11684,88, ,209,121
H,2,11893,124, ,1246,1122
H,2,13139,76, ,152,76
H,2,13291,129,a,101,-28
H,2,13392,132, ,1249,1117
H,2,14641,76,t,48,-28
H,2,14689,108,o,241,133
H,2,14930,93, ,214,121
H,2,15144,88,b,93,5
H,2,15237,123,e,76,-47
H,2,15313,98, ,144,46
H,2,15457,155,a,63,-92
H,2,15520,99, ,200,101
H,2,15720,120, ,18137,18017
H,2,33857,164,S,123,-41
H,2,33980,84,h,171,87
H,2,34151,112,i,109,-3
H,2,34260,136,r,211,75
H,2,34471,144,p,802,658
H,2,35273,148,r,262,114
H,2,35535,139,i,136,-3
H,2,35671,132,m,224,92
H,2,35895,112,p,307,195
H,2,36202,111, ,7258,7147
H,2,43460,145,s,197,52
H,2,43657,96,u,107,11
H,2,43764,145,h,60,-85
H,2,43824,157,s,149,-8
H,2,43973,126,i,312,186
H,2,44285,88,",",117,29
H,2,44402,133, ,1216,1083
H,2,45618,147,s,144,-3
H,2,45762,104,h,100,-4
H,2,45862,104,i,234,130
H,2,46096,68,",",129,61
H,2,46225,85, ,176,91
H,2,46401,76,I,156,80
H,2,46557,128, ,1771,1643
H,2,48328,73,.,181,108
H,2,48509,104, ,257,153
H,2,48766,92,I,211,119
H,2,48977,103, ,675,572
H,2,49652,82,g,160,78
H,2,49812,124,r,108,-16
H,2,49920,84,o,124,40
H,2,50044,84,w,231,147
H,2,50275,116,n,153,37
H,2,50428,128, ,237,109
H,2,50665,147,a,483,336
H,2,51148,111,l,326,215
H,2,51474,63,y,758,695
H,2,52232,125, ,197,72
H,2,52429,83,l,163,80
H,2,52592,88,o,89,1
H,2,52681,119,y,135,16
H,2,52816,76, ,147,71
H,2,52963,113,i,81,-32
H,2,53044,112,n,3358,3246
H,2,56402,75,o,92,17
H,2,56494,122,w,108,-14
H,2,56602,72,n,155,83
H,2,56757,92, ,40,-52
H,2,56797,155,a,148,-7
H,2,56945,96, ,228,132
H,2,57173,73,l,174,101
H,2,57347,46,i,42,-4
H,2,57389,31,t,153,122
H,2,57542,126,t,125,-1
H,2,57667,104,l,133,29
H,2,57800,148,e,91,-57
H,2,57891,113, ,257,144
H,2,58148,135,f,124,-11
H,2,58272,75,o,72,-3
H,2,58344,136,r,124,-12
H,2,58468,84, ,544,460
H,2,59012,82,s,71,-11
H,2,59083,75,u,157,82
H,2,59240,116,h,7,-109
H,2,59247,156,s,140,-16
H,2,59387,161,i,1134,973
H,2,60521,143,s,120,-23
H,2,60641,88,h,104,16
H,2,60745,169,i,277,108
H,2,61022,152, ,703,551
H,2,61725,165,i,112,-53
H,2,61837,165,n,192,27
H,2,62029,173, ,1161,988
H,2,63190,103,i,80,-23
H,2,63270,111,n,148,37
H,2,63418,85, ,97,12
H,2,63515,99,t,96,-3
H,2,63611,67,h,110,43
H,2,63721,100,e,52,-48
H,2,63773,72, ,178,106
H,2,63951,77,p,20,-57
H,2,63971,173,a,106,-67
H,2,64077,159,s,135,-24
H,2,64212,132,t,100,-32
H,2,64312,80, ,128,48
H,2,64440,123,w,92,-31
H,2,64532,87,e,161,74
H,2,64693,157,e,133,-24
H,2,64826,111,k,194,83
H,2,65020,140, ,1213,1073
H,2,66233,132,w,135,3
H,2,66368,129,r,1185,1056
H,2,67553,95,y,76,-19
H,2,67629,160,e,11,-149
H,2,67640,172,a,533,361
H,2,68173,91,s,2289,2198
H,2,70462,27,g,57,30
H,2,70519,61,o,473,412
H,2,70992,127,f,163,36
H,2,71155,60,o,163,103
H,2,71318,64,u,117,53
H,2,71435,107,r,92,-15
H,2,71527,68, ,198,130
H,2,71725,101,y,56,-45
H,2,71781,272,e,83,-189
H,2,71864,176,a,160,-16
H,2,72024,156,t,125,-31
H,2,72149,164,s,685,521
H,2,72834,129,t,573,444
H,2,73407,139,r,77,-62
H,2,73484,163,s,717,554
H,2,74201,169,a,646,477
H,2,74847,134,r,103,-31
H,2,74950,176,s,136,-40
H,2,75086,112,.,42129,42017
H,2,117215,108, ,1479,1371
H,2,118694,92,M,236,144
H,2,118930,129,y,151,22
H,2,119081,105, ,4434,4329
H,2,123515,108,f,55,-53
H,2,123570,136,a,180,44
H,2,123750,92,v,81,-11
H,2,123831,89,o,124,35
H,2,123955,149,r,530,381
H,2,124485,120,i,274,154
H,2,124759,189,t,101,-88
H,2,124860,135,e,136,1
H,2,124996,144, ,2794,2650
H,2,127790,96,g,107,11
H,2,127897,56,o,179,123
H,2,128076,85, ,1816,1731
H,2,129892,128,t,202,74
H,2,130094,92,o,233,141
H,2,130327,121, ,1659,1538
H,2,131986,100,r,48,-52
H,2,132034,84,o,192,108
H,2,132226,56,l,142,86
H,2,132368,96,l,181,85
H,2,132549,68, ,118,50
H,2,132667,88,i,89,1
H,2,132756,79,n,197,118
H,2,132953,64, ,718,654
H,2,133671,130,s,132,2
H,2,133803,57, ,135,78
H,2,133938,100,t,62,-38
H,2,134000,80,h,120,40
H,2,134120,134,e,69,-65
H,2,134189,100, ,344,244
H,2,134533,88,h,95,7
H,2,134628,149,a,245,96
H,2,134873,149,w,475,326
H,2,135348,99,i,385,286
H,2,135733,192,a,199,7
H,2,135932,65,n,155,90
H,2,136087,88,n,221,133
H,2,136308,121, ,2317,2196
H,2,138625,127,s,124,-3
H,2,138749,68,p,182,114
H,2,138931,79,i,23,-56
H,2,138954,128,c,264,136
H,2,139218,76,y,203,127
H,2,139421,68, ,1131,1063
H,2,140552,137,s,172,35
H,2,140724,96,h,191,95
H,2,140915,62,i,636,574
H,2,141551,147,r,133,-14
H,2,141684,87,i,64,-23
H,2,141748,95,m,164,69
H,2,141912,88,p,211,123
H,2,142123,68, ,222,154
H,2,142345,99,r,283,184
H,2,142628,59,o,178,119
H,2,142806,68,l,151,83
H,2,142957,136,l,6133,5997
H,2,149090,92,.,211,119
H,2,149301,84, ,496,412
H,2,149797,88,I,196,108
H,2,149993,116, ,1777,1661
H,2,151770,79,p,236,157
H,2,152006,134,r,98,-36
H,2,152104,134,e,173,39
H,2,152277,132,f,121,-11
H,2,152398,167,e,136,-31
H,2,152534,108,r,124,16
H,2,152658,68, ,95,27
H,2,152753,101,t,85,-16
H,2,152838,52,o,149,97
H,2,152987,87, ,751,664
H,2,153738,168,e,96,-72
H,2,153834,183,a,176,-7
H,2,154010,124,t,149,25
H,2,154159,104, ,248,144
H,2,154407,144,a,183,39
H,2,154590,157,t,173,16
H,2,154763,92, ,242,150
H,2,155005,131,a,124,-7
H,2,155129,75,l,159,84
H,2,155288,92,l,1940,1848
H,2,157228,124,y,96,-28
H,2,157324,79,o,177,98
H,2,157501,80,u,1064,984
H,2,158565,157,c,59,-98
H,2,158624,139,a,99,-40
H,2,158723,101,n,182,81
H,2,158905,47, ,641,594
H,2,159546,151,e,59,-92
H,2,159605,187,a,144,-43
H,2,159749,160,t,189,29
H,2,159938,96, ,545,449
H,2,160483,129,s,155,26
H,2,160638,134,i,891,757
H,2,161529,96,u,134,38
H,2,161663,152,s,147,-5
H,2,161810,136,h,158,22
H,2,161968,141,i,50248,50107
H,2,212216,103,i,214,111
H,2,212430,76,k,159,83
H,2,212589,120,i,87,-33
H,2,212676,129,n,105,-24
H,2,212781,128,g,517,389
H,2,213298,117, ,6050,5933
H,2,219348,80, ,201,121
H,2,219549,150,p,104,-46
H,2,219653,141,l,46,-95
H,2,219699,154,a,134,-20
H,2,219833,201,c,109,-92
H,2,219942,203,e,93,-110
H,2,220035,170,s,483,313
H,2,220518,136,",",224,88
H,2,220742,129, ,1096,967
H,2,221838,75,b,2456,2381
H,2,224294,132, ,386,254
H,2,224680,146,t,109,-37
H,2,224789,107,o,240,133
H,2,225029,124, ,1194,1070
H,2,226223,100, ,139,39
H,2,226362,119,t,92,-27
H,2,226454,83,o,150,67
H,2,226604,129, ,385,256
H,2,226989,172,t,153,-19
H,2,227142,155,r,132,-23
H,2,227274,103,y,142,39
H,2,227416,81, ,124,43
H,2,227540,144,a,76,-68
H,2,227616,100, ,992,892
H,2,228608,142,v,98,-44
H,2,228706,167,a,123,-44
H,2,228829,144,r,156,12
H,2,228985,123,i,81,-42
H,2,229066,126,e,106,-20
H,2,229172,73,r,205,132
H,2,229377,104,y,160,56
H,2,229537,124, ,246,122
H,2,229783,59,o,11,-48
H,2,229794,116,f,185,69
H,2,229979,117, ,1470,1353
H,2,231449,155,t,76,-79
H,2,231525,111,y,123,12
H,2,231648,96, ,155,59
H,2,231803,89,o,84,-5
H,2,231887,117,f,132,15
H,2,232019,73, ,1358,1285
H,2,233377,108,r,97,-11
H,2,233474,56,o,156,100
H,2,233630,52,l,96,44
H,2,233726,93,l,311,218
H,2,234037,146,s,102,-44
H,2,234139,88,.,NA,NA
I,1,195,161,F,198,37
I,1,393,193,a,302,109
I,1,695,124,r,99,-25
I,1,794,178, ,144,-34
I,1,938,237,o,76,-161
I,1,1014,187,u,127,-60
I,1,1141,144,t,87,-57
I,1,1228,143, ,77,-66
I,1,1305,133,i,64,-69
I,1,1369,90,n,53,-37
I,1,1422,121, ,36,-85
I,1,1458,156,t,56,-100
I,1,1514,129,h,62,-67
I,1,1576,168,e,66,-102
I,1,1642,133, ,114,-19
I,1,1756,191,u,58,-133
I,1,1814,204,n,343,139
I,1,2157,127,c,65,-62
I,1,2222,163,h,154,-9
I,1,2376,102,a,44,-58
I,1,2420,145,r,173,28
I,1,2593,130,t,67,-63
I,1,2660,123,e,150,27
I,1,2810,110,d,66,-44
I,1,2876,155, ,111,-44
I,1,2987,109,b,65,-44
I,1,3052,123,a,54,-69
I,1,3106,123,c,68,-55
I,1,3174,156,k,99,-57
I,1,3273,114,w,48,-66
I,1,3321,143,a,99,-44
I,1,3420,130,t,98,-32
I,1,3518,178,e,106,-72
I,1,3624,192,r,131,-61
I,1,3755,167,s,50,-117
I,1,3805,142, ,115,-27
I,1,3920,156,o,38,-118
I,1,3958,123,f,219,96
I,1,4177,179, ,83,-96
I,1,4260,178,t,77,-101
I,1,4337,178,h,60,-118
I,1,4397,189,e,162,-27
I,1,4559,153, ,236,83
I,1,4795,95,f,197,102
I,1,4992,159,a,27,-132
I,1,5019,167,s,766,599
I,1,5785,163,u,66,-97
I,1,5851,147,n,66,-81
I,1,5917,95,f,71,-24
I,1,5988,139,a,66,-73
I,1,6054,169,s,27,-142
I,1,6081,112,h,193,81
I,1,6274,133,i,41,-92
I,1,6315,113,o,347,234
I,1,6662,139,n,154,15
I,1,6816,133,a,60,-73
I,1,6876,103,b,194,91
I,1,7070,145,l,153,8
I,1,7223,126, ,86,-40
I,1,7309,98,e,352,254
I,1,7661,105,e,133,28
I,1,7794,127, ,32,-95
I,1,7826,156,e,60,-96
I,1,7886,163,n,145,-18
I,1,8031,132,d,86,-46
I,1,8117,140, ,72,-68
I,1,8189,139,o,52,-87
I,1,8241,98,f,90,-8
I,1,8331,159, ,39,-120
I,1,8370,191,t,58,-133
I,1,8428,150,h,52,-98
I,1,8480,120,e,93,-27
I,1,8573,134, ,79,-55
I,1,8652,144,w,87,-57
I,1,8739,172,e,117,-55
I,1,8856,123,s,114,-9
I,1,8970,112,t,82,-30
I,1,9052,151,e,72,-79
I,1,9124,164,r,44,-120
I,1,9168,96,n,87,-9
I,1,9255,129, ,82,-47
I,1,9337,153,s,19,-134
I,1,9356,109,p,180,71
I,1,9536,146,i,110,-36
I,1,9646,156,r,60,-96
I,1,9706,144,a,83,-61
I,1,9789,150,l,129,-21
I,1,9918,147, ,70,-77
I,1,9988,171,a,43,-128
I,1,10031,153,r,65,-88
I,1,10096,124,m,89,-35
I,1,10185,144, ,170,26
I,1,10355,155,o,43,-112
I,1,10398,114,f,168,54
I,1,10566,169, ,45,-124
I,1,10611,177,t,78,-99
I,1,10689,178,h,59,-119
I,1,10748,135,e,110,-25
I,1,10858,124, ,916,792
I,1,11774,137,G,204,67
I,1,11978,109,a,133,24
I,1,12111,140,l,103,-37
I,1,12214,168,a,117,-51
I,1,12331,149,x,406,257
I,1,12737,151,y,153,2
I,1,12890,107, ,253,146
I,1,13143,194,l,121,-73
I,1,13264,150,i,27,-123
I,1,13291,150,e,55,-95
I,1,13346,163,s,105,-58
I,1,13451,111, ,68,-43
I,1,13519,155,a,113,-42
I,1,13632,174, ,77,-97
I,1,13709,260,s,83,-177
I,1,13792,111,m,180,69
I,1,13972,174,a,68,-106
I,1,14040,105,l,121,16
I,1,14161,105,l,175,70
I,1,14336,144, ,42,-102
I,1,14378,163,u,72,-91
I,1,14450,163,n,400,237
I,1,14850,119,r,72,-47
I,1,14922,113,e,110,-3
I,1,15032,133,g,142,9
I,1,15174,179,a,72,-107
I,1,15246,145,r,186,41
I,1,15432,156,d,104,-52
I,1,15536,241,e,116,-125
I,1,15652,191,d,118,-73
I,1,15770,153, ,64,-89
I,1,15834,105,y,129,24
I,1,15963,140,e,82,-58
I,1,16045,101,l,149,48
I,1,16194,79,l,132,53
I,1,16326,145,o,275,130
I,1,16601,134,w,79,-55
I,1,16680,188, ,130,-58
I,1,16810,194,s,77,-117
I,1,16887,140,u,62,-78
I,1,16949,116,n,612,496
I,1,17561,145,.,885,740
I,1,18446,243,O,22885,22642
I,1,41331,195,r,88,-107
I,1,41419,221,b,144,-77
I,1,41563,139,i,197,58
I,1,41760,150,t,118,-32
I,1,41878,158,i,854,696
I,1,42732,168,n,60,-108
I,1,42792,162,g,816,654
I,1,43608,204, ,291,87
I,1,43899,145,t,99,-46
I,1,43998,161,h,34,-127
I,1,44032,175,i,119,-56
I,1,44151,183,s,149,-34
I,1,44300,162, ,132,-30
I,1,44432,152,a,162,10
I,1,44594,124,t,85,-39
I,1,44679,130, ,121,-9
I,1,44800,199,a,80,-119
I,1,44880,154, ,86,-68
I,1,44966,176,i,8,-168
I,1,44974,181,d,151,-30
I,1,45125,177,s,137,-40
I,1,45262,107,t,71,-36
I,1,45333,166,a,1125,959
I,1,46458,182,d,117,-65
I,1,46575,103,i,92,-11
I,1,46667,193,s,142,-51
I,1,46809,143,t,104,-39
I,1,46913,155,a,55,-100
I,1,46968,172,n,189,17
I,1,47157,98,c,16,-82
I,1,47173,199,e,86,-113
I,1,47259,164, ,370,206
I,1,47629,161,o,105,-56
I,1,47734,133,f,72,-61
I,1,47806,161, ,81,-80
I,1,47887,168,r,77,-91
I,1,47964,158,o,54,-104
I,1,48018,108,u,94,-14
I,1,48112,139,g,61,-78
I,1,48173,109,h,177,68
I,1,48350,154,l,86,-68
I,1,48436,129,y,191,62
I,1,48627,156, ,217,61
I,1,48844,72,n,115,43
I,1,48959,184,i,82,-102
I,1,49041,106,n,85,-21
I,1,49126,147,e,109,-38
I,1,49235,127,t,211,84
I,1,49446,184,y,404,220
I,1,49850,154,t,73,-81
I,1,49923,229,w,92,-137
I,1,50015,154,o,132,-22
I,1,50147,150, ,116,-34
I,1,50263,156,m,71,-85
I,1,50334,106,i,194,88
I,1,50528,89,l,133,44
I,1,50661,110,l,135,25
I,1,50796,161,i,107,-54
I,1,50903,82,o,177,95
I,1,51080,108,n,94,-14
I,1,51174,180, ,143,-37
I,1,51317,168,m,11,-157
I,1,51328,159,i,245,86
I,1,51573,159,l,55,-104
I,1,51628,154,e,65,-89
I,1,51693,166,s,87,-79
I,1,51780,186, ,99,-87
I,1,51879,161,i,84,-77
I,1,51963,166,s,93,-73
I,1,52056,139, ,82,-57
I,1,52138,175,a,66,-109
I,1,52204,118,n,99,-19
I,1,52303,144, ,100,-44
I,1,52403,143,u,75,-68
I,1,52478,106,t,144,38
I,1,52622,105,t,61,-44
I,1,52683,194,e,103,-91
I,1,52786,135,r,93,-42
I,1,52879,140,l,175,35
I,1,53054,127, ,94,-33
I,1,53148,83,y,369,286
I,1,53517,133,y,368,235
I,1,53885,138,y,56,-82
I,1,53941,139, ,153,14
I,1,54094,111,i,174,63
I,1,54268,122,n,73,-49
I,1,54341,132,s,87,-45
I,1,54428,112,i,79,-33
I,1,54507,154,g,103,-51
I,1,54610,94,i,111,17
I,1,54721,137,f,92,-45
I,1,54813,107,n,98,-9
I,1,54911,147,i,157,10
I,1,55068,158,c,86,-72
I,1,55154,193,a,77,-116
I,1,55231,158,n,154,-4
I,1,55385,210,t,126,-84
I,1,55511,150, ,1763,1613
I,1,57274,150,i,127,-23
I,1,57401,122,c,76,-46
I,1,57477,174,a,123,-51
I,1,57600,160,n,82,-78
I,1,57682,174,t,103,-71
I,1,57785,123, ,2213,2090
I,1,59998,198,l,105,-93
I,1,60103,133,i,38,-95
I,1,60141,106,t,151,45
I,1,60292,183,t,66,-117
I,1,60358,140,l,83,-57
I,1,60441,152,e,105,-47
I,1,60546,182, ,88,-94
I,1,60634,174,b,72,-102
I,1,60706,226,l,86,-140
I,1,60792,157,u,107,-50
I,1,60899,144,e,75,-69
I,1,60974,233, ,105,-128
I,1,61079,129,g,188,59
I,1,61267,160,r,65,-95
I,1,61332,123,e,155,32
I,1,61487,189,e,107,-82
I,1,61594,109,n,68,-41
I,1,61662,161, ,132,-29
I,1,61794,151,p,71,-80
I,1,61865,151,l,86,-65
I,1,61951,144,a,159,15
I,1,62110,164,n,158,-6
I,1,62268,177,e,52,-125
I,1,62320,166,t,116,-50
I,1,62436,149, ,87,-62
I,1,62523,140,w,83,-57
I,1,62606,174,h,40,-134
I,1,62646,160,o,102,-58
I,1,62748,159,s,72,-87
I,1,62820,200,e,77,-123
I,1,62897,128, ,89,-39
I,1,62986,178,a,59,-119
I,1,63045,152,p,155,3
I,1,63200,155,e,215,60
I,1,63415,166,d,82,-84
I,1,63497,272,e,98,-174
I,1,63595,238,s,166,-72
I,1,63761,184,c,55,-129
I,1,63816,127,r,106,-21
I,1,63922,154,n,656,502
I,1,64578,144,e,106,-38
I,1,64684,178,n,531,353
I,1,65215,231,d,205,-26
I,1,65420,235,e,207,-28
I,1,65627,237,d,88,-149
I,1,65715,134, ,214,80
I,1,65929,211,l,77,-134
I,1,66006,144,i,44,-100
I,1,66050,149,f,88,-61
I,1,66138,195,e,88,-107
I,1,66226,199, ,71,-128
I,1,66297,157,f,116,-41
I,1,66413,78,o,61,-17
I,1,66474,165,r,190,25
I,1,66664,180,m,88,-92
I,1,66752,167,s,101,-66
I,1,66853,160, ,119,-41
I,1,66972,150,a,55,-95
I,1,67027,134,r,41,-93
I,1,67068,164,e,126,-38
I,1,67194,140, ,98,-42
I,1,67292,166,s,104,-62
I,1,67396,146,o,120,-26
I,1,67516,156, ,72,-84
I,1,67588,113,a,79,-34
I,1,67667,167,m,92,-75
I,1,67759,107,a,166,59
I,1,67925,154,z,42,-112
I,1,67967,162,i,83,-79
I,1,68050,121,n,59,-62
I,1,68109,154,g,155,1
I,1,68264,133,l,90,-43
I,1,68354,115,y,81,-34
I,1,68435,124, ,77,-47
I,1,68512,122,p,109,-13
I,1,68621,142,r,94,-48
I,1,68715,156,i,181,25
I,1,68896,286,m,119,-167
I,1,69015,161,i,187,26
I,1,69202,152,t,116,-36
I,1,69318,176,i,278,102
I,1,69596,137,v,48,-89
I,1,69644,205,e,139,-66
I,1,69783,188, ,71,-117
I,1,69854,160,t,77,-83
I,1,69931,159,h,128,-31
I,1,70059,147,a,41,-106
I,1,70100,95,t,78,-17
I,1,70178,172, ,77,-95
I,1,70255,188,t,44,-144
I,1,70299,186,h,109,-77
I,1,70408,176,e,94,-82
I,1,70502,132,y,71,-61
I,1,70573,161, ,95,-66
I,1,70668,146,s,71,-75
I,1,70739,155,t,39,-116
I,1,70778,133,i,27,-106
I,1,70805,113,l,178,65
I,1,70983,112,l,88,-24
I,1,71071,147, ,40,-107
I,1,71111,197,t,37,-160
I,1,71148,123,h,61,-62
I,1,71209,107,i,162,55
I,1,71371,123,n,38,-85
I,1,71409,145,k,121,-24
I,1,71530,166, ,44,-122
I,1,71574,156,d,78,-78
I,1,71652,105,i,123,18
I,1,71775,119,g,92,-27
I,1,71867,124,i,87,-37
I,1,71954,172,t,107,-65
I,1,72061,170,a,75,-95
I,1,72136,154,l,126,-28
I,1,72262,147, ,88,-59
I,1,72350,201,w,143,-58
I,1,72493,171,a,60,-111
I,1,72553,147,t,204,57
I,1,72757,122,c,57,-65
I,1,72814,136,h,126,-10
I,1,72940,214,e,75,-139
I,1,73015,190,s,129,-61
I,1,73144,125, ,71,-54
I,1,73215,133,a,136,3
I,1,73351,133, ,82,-51
I,1,73433,101,a,78,-23
I,1,73511,163,r,21,-142
I,1,73532,184,e,140,-44
I,1,73672,92, ,70,-22
I,1,73742,154,a,99,-55
I,1,73841,117, ,70,-47
I,1,73911,183,p,106,-77
I,1,74017,182,r,38,-144
I,1,74055,178,e,55,-123
I,1,74110,173,a,191,18
I,1,74301,130,t,160,30
I,1,74461,88,t,233,145
I,1,74694,146,y,155,9
I,1,74849,123, ,153,30
I,1,75002,157,n,76,-81
I,1,75078,217,e,72,-145
I,1,75150,157,a,72,-85
I,1,75222,276,r,457,181
I,1,75679,143, ,600,457
I,1,76279,171,t,552,381
I,1,76831,107, ,260,153
I,1,77091,140, ,285,145
I,1,77376,130,i,54,-76
I,1,77430,195,d,45,-150
I,1,77475,196,e,116,-80
I,1,77591,121,a,0,-121
I,1,77591,253,.,191,-62
I,1,77782,92, ,1114,1022
I,1,78896,166,T,367,201
I,1,79263,128,h,77,-51
I,1,79340,144,i,88,-56
I,1,79428,128,s,79,-49
I,1,79507,139, ,75,-64
I,1,79582,152,p,55,-97
I,1,79637,133,l,71,-62
I,1,79708,162,a,205,43
I,1,79913,168,n,166,-2
I,1,80079,174,e,143,-31
I,1,80222,134,t,143,9
I,1,80365,134, ,153,19
I,1,80518,134,h,103,-31
I,1,80621,166,a,87,-79
I,1,80708,169,s,82,-87
I,1,80790,147,",",164,17
I,1,80954,90, ,44,-46
I,1,80998,171,o,116,-55
I,1,81114,121,r,125,4
I,1,81239,173, ,62,-111
I,1,81301,138,r,93,-45
I,1,81394,132,a,104,-28
I,1,81498,154,t,65,-89
I,1,81563,170,h,79,-91
I,1,81642,165,e,81,-84
I,1,81723,139,r,66,-73
I,1,81789,151, ,83,-68
I,1,81872,128,h,100,-28
I,1,81972,172,a,37,-135
I,1,82009,185,d,136,-49
I,1,82145,161,",",197,36
I,1,82342,119, ,106,-13
I,1,82448,150,a,76,-74
I,1,82524,140, ,87,-53
I,1,82611,141,p,113,-28
I,1,82724,128,r,114,-14
I,1,82838,139,o,155,16
I,1,82993,187,b,153,-34
I,1,83146,156,l,143,-13
I,1,83289,172,e,58,-114
I,1,83347,165,m,204,39
I,1,83551,177,",",174,-3
I,1,83725,113, ,78,-35
I,1,83803,132,w,44,-88
I,1,83847,148,h,53,-95
I,1,83900,112,i,151,39
I,1,84051,180,c,75,-105
I,1,84126,145,h,95,-50
I,1,84221,205, ,93,-112
I,1,84314,149,w,89,-60
I,1,84403,203,a,108,-95
I,1,84511,180,s,98,-82
I,1,84609,180, ,73,-107
I,1,84682,160,t,33,-127
I,1,84715,133,h,73,-60
I,1,84788,149,i,121,-28
I,1,84909,83,s,167,84
I,1,85076,126,:,116,-10
I,1,85192,136, ,99,-37
I,1,85291,221,m,95,-126
I,1,85386,150,o,99,-51
I,1,85485,126,s,10,-116
I,1,85495,155,t,55,-100
I,1,85550,167, ,104,-63
I,1,85654,168,o,104,-64
I,1,85758,95,f,62,-33
I,1,85820,178, ,70,-108
I,1,85890,197,t,51,-146
I,1,85941,112,h,54,-58
I,1,85995,171,e,105,-66
I,1,86100,133, ,56,-77
I,1,86156,153,p,115,-38
I,1,86271,158,e,48,-110
I,1,86319,133,o,102,-31
I,1,86421,208,p,108,-100
I,1,86529,154,l,76,-78
I,1,86605,197,e,94,-103
I,1,86699,127, ,93,-34
I,1,86792,150,o,61,-89
I,1,86853,141,n,105,-36
I,1,86958,110, ,71,-39
I,1,87029,157,i,72,-85
I,1,87101,127,t,77,-50
I,1,87178,155, ,93,-62
I,1,87271,121,w,167,46
I,1,87438,106,e,54,-52
I,1,87492,184,r,94,-90
I,1,87586,174,e,49,-125
I,1,87635,155, ,61,-94
I,1,87696,145,u,49,-96
I,1,87745,98,n,168,70
I,1,87913,96,h,94,-2
I,1,88007,111,a,115,4
I,1,88122,90,p,106,16
I,1,88228,165,p,61,-104
I,1,88289,165,y,119,-46
I,1,88408,152, ,148,-4
I,1,88556,156,f,81,-75
I,1,88637,133,o,91,-42
I,1,88728,134,r,76,-58
I,1,88804,150, ,71,-79
I,1,88875,173,p,67,-106
I,1,88942,114,r,44,-70
I,1,88986,193,e,120,-73
I,1,89106,117,t,142,25
I,1,89248,130,t,149,19
I,1,89397,135,y,88,-47
I,1,89485,118, ,121,3
I,1,89606,201,m,139,-62
I,1,89745,133,u,142,9
I,1,89887,165,c,83,-82
I,1,89970,128,h,171,43
I,1,90141,105, ,67,-38
I,1,90208,155,o,174,19
I,1,90382,113, ,21,-92
I,1,90403,93,t,491,398
I,1,90894,112,f,116,4
I,1,91010,195, ,60,-135
I,1,91070,191,t,71,-120
I,1,91141,123,h,61,-62
I,1,91202,149,e,104,-45
I,1,91306,211, ,36,-175
I,1,91342,216,t,85,-131
I,1,91427,151,i,50,-101
I,1,91477,132,m,116,-16
I,1,91593,145,e,87,-58
I,1,91680,178,.,165,-13
I,1,91845,144, ,132,-12
I,1,91977,155,M,197,42
I,1,92174,108,a,83,-25
I,1,92257,184,n,181,-3
I,1,92438,131,y,111,-20
I,1,92549,120, ,135,15
I,1,92684,172,s,71,-101
I,1,92755,119,o,186,67
I,1,92941,118,l,194,76
I,1,93135,100,u,128,28
I,1,93263,172,t,54,-118
I,1,93317,99,i,27,-72
I,1,93344,133,o,178,45
I,1,93522,178,n,72,-106
I,1,93594,111,s,86,-25
I,1,93680,174, ,83,-91
I,1,93763,129,w,182,53
I,1,93945,84,e,59,-25
I,1,94004,157,r,83,-74
I,1,94087,137,e,97,-40
I,1,94184,148, ,61,-87
I,1,94245,141,s,78,-63
I,1,94323,116,u,88,-28
I,1,94411,87,g,127,40
I,1,94538,149,g,83,-66
I,1,94621,122,e,29,-93
I,1,94650,219,s,157,-62
I,1,94807,84,t,33,-51
I,1,94840,130,e,207,77
I,1,95047,127,d,89,-38
I,1,95136,154, ,59,-95
I,1,95195,129,f,83,-46
I,1,95278,180,o,93,-87
I,1,95371,96,r,77,-19
I,1,95448,172, ,54,-118
I,1,95502,169,t,56,-113
I,1,95558,123,h,51,-72
I,1,95609,145,i,76,-69
I,1,95685,161,s,81,-80
I,1,95766,195, ,68,-127
I,1,95834,134,p,76,-58
I,1,95910,123,r,83,-40
I,1,95993,133,o,120,-13
I,1,96113,144,b,72,-72
I,1,96185,119,l,133,14
I,1,96318,190,e,88,-102
I,1,96406,116,m,200,84
I,1,96606,139,",",180,41
I,1,96786,122, ,55,-67
I,1,96841,157,b,77,-80
I,1,96918,165,u,186,21
I,1,97104,180,t,84,-96
I,1,97188,171, ,1485,1314
I,1,98673,184,m,87,-97
I,1,98760,158,o,50,-108
I,1,98810,193,s,94,-99
I,1,98904,137,t,76,-61
I,1,98980,113, ,71,-42
I,1,99051,144,o,57,-87
I,1,99108,92,f,71,-21
I,1,99179,157, ,48,-109
I,1,99227,175,t,50,-125
I,1,99277,166,h,39,-127
I,1,99316,128,e,78,-50
I,1,99394,209,s,103,-106
I,1,99497,156,e,105,-51
I,1,99602,160, ,109,-51
I,1,99711,139,w,179,40
I,1,99890,120,e,72,-48
I,1,99962,167,r,99,-68
I,1,100061,145,e,78,-67
I,1,100139,181, ,86,-95
I,1,100225,163,l,77,-86
I,1,100302,140,a,45,-95
I,1,100347,124,r,183,59
I,1,100530,134,g,43,-91
I,1,100573,183,e,216,33
I,1,100789,161,l,395,234
I,1,101184,116,y,146,30
I,1,101330,134, ,152,18
I,1,101482,145,c,71,-74
I,1,101553,194,o,61,-133
I,1,101614,174,n,82,-92
I,1,101696,102,c,90,-12
I,1,101786,188,e,158,-30
I,1,101944,144,r,83,-61
I,1,102027,159,n,65,-94
I,1,102092,178,e,159,-19
I,1,102251,183,d,247,64
I,1,102498,147, ,565,418
I,1,103063,147,w,92,-55
I,1,103155,123,i,114,-9
I,1,103269,147,t,55,-92
I,1,103324,142,h,82,-60
I,1,103406,126, ,51,-75
I,1,103457,179,t,48,-131
I,1,103505,147,h,33,-114
I,1,103538,179,e,88,-91
I,1,103626,141, ,110,-31
I,1,103736,174,m,82,-92
I,1,103818,163,o,78,-85
I,1,103896,172,v,49,-123
I,1,103945,133,e,138,5
I,1,104083,105,m,66,-39
I,1,104149,90,e,89,-1
I,1,104238,162,n,70,-92
I,1,104308,127,e,66,-61
I,1,104374,180,t,94,-86
I,1,104468,168,s,88,-80
I,1,104556,117, ,99,-18
I,1,104655,137,o,82,-55
I,1,104737,140,f,115,-25
I,1,104852,112, ,89,-23
I,1,104941,144,s,72,-72
I,1,105013,117,m,109,-8
I,1,105122,139,a,88,-51
I,1,105210,90,l,124,34
I,1,105334,129,l,38,-91
I,1,105372,133, ,45,-88
I,1,105417,133,a,116,-17
I,1,105533,147,g,339,192
I,1,105872,91,g,148,57
I,1,106020,123,r,48,-75
I,1,106068,100,e,157,57
I,1,106225,191,e,85,-106
I,1,106310,122,n,96,-26
I,1,106406,140, ,254,114
I,1,106660,215,p,670,455
I,1,107330,91,e,86,-5
I,1,107416,98,i,467,369
I,1,107883,129,i,45,-84
I,1,107928,183,e,148,-35
I,1,108076,257,c,99,-158
I,1,108175,243,e,61,-182
I,1,108236,220,s,137,-83
I,1,108373,114, ,87,-27
I,1,108460,151,o,111,-40
I,1,108571,161,f,76,-85
I,1,108647,202, ,196,-6
I,1,108843,113,a,353,240
I,1,109196,114,p,78,-36
I,1,109274,134,a,110,-24
I,1,109384,154,p,71,-83
I,1,109455,188,e,55,-133
I,1,109510,216,r,60,-156
I,1,109570,145,",",121,-24
I,1,109691,134, ,50,-84
I,1,109741,160,w,88,-72
I,1,109829,144,h,55,-89
I,1,109884,123,i,105,-18
I,1,109989,222,c,79,-143
I,1,110068,132,h,46,-86
I,1,110114,187, ,178,-9
I,1,110292,127,i,72,-55
I,1,110364,160,s,102,-58
I,1,110466,129, ,83,-46
I,1,110549,196,o,101,-95
I,1,110650,93,d,112,19
I,1,110762,164,d,116,-48
I,1,110878,162, ,39,-123
I,1,110917,216,b,121,-95
I,1,111038,155,e,115,-40
I,1,111153,120,c,82,-38
I,1,111235,220,a,72,-148
I,1,111307,190,u,57,-133
I,1,111364,165,s,81,-84
I,1,111445,188,e,93,-95
I,1,111538,123, ,55,-68
I,1,111593,169,o,56,-113
I,1,111649,138,n,99,-39
I,1,111748,184, ,48,-136
I,1,111796,213,t,78,-135
I,1,111874,137,h,55,-82
I,1,111929,134,e,131,-3
I,1,112060,112, ,256,144
I,1,112316,183,w,79,-104
I,1,112395,158,h,64,-94
I,1,112459,117,o,198,81
I,1,112657,157,l,143,-14
I,1,112800,195,e,110,-85
I,1,112910,142, ,115,-27
I,1,113025,205,i,138,-67
I,1,113163,184,t,707,523
I,1,113870,190, ,51,-139
I,1,113921,160,w,119,-41
I,1,114040,164,a,83,-81
I,1,114123,163,s,10,-153
I,1,114133,103,n,172,69
I,1,114305,128,',73,-55
I,1,114378,113,t,92,-21
I,1,114470,122, ,40,-82
I,1,114510,183,t,61,-122
I,1,114571,150,h,26,-124
I,1,114597,134,e,123,-11
I,1,114720,133, ,64,-69
I,1,114784,204,s,44,-160
I,1,114828,117,m,94,-23
I,1,114922,175,a,87,-88
I,1,115009,75,l,105,30
I,1,115114,134,l,198,64
I,1,115312,180, ,73,-107
I,1,115385,129,g,195,66
I,1,115580,118,r,28,-90
I,1,115608,140,e,161,21
I,1,115769,184,e,116,-68
I,1,115885,148,n,138,-10
I,1,116023,188, ,143,-45
I,1,116166,188,p,61,-127
I,1,116227,147,i,99,-48
I,1,116326,152,e,142,-10
I,1,116468,172,c,60,-112
I,1,116528,210,e,61,-149
I,1,116589,201,s,100,-101
I,1,116689,126, ,498,372
I,1,117187,144,o,98,-46
I,1,117285,138,f,71,-67
I,1,117356,172, ,72,-100
I,1,117428,118,p,120,2
I,1,117548,135,a,105,-30
I,1,117653,143,p,28,-115
I,1,117681,218,e,105,-113
I,1,117786,132,r,103,-29
I,1,117889,207, ,60,-147
I,1,117949,158,t,83,-75
I,1,118032,150,h,121,-29
I,1,118153,199,a,342,143
I,1,118495,124,t,122,-2
I,1,118617,185, ,82,-103
I,1,118699,126,w,183,57
I,1,118882,124,e,66,-58
I,1,118948,183,r,83,-100
I,1,119031,182,e,287,105
I,1,119318,95, ,180,85
I,1,119498,134, ,283,149
I,1,119781,147,u,53,-94
I,1,119834,143,n,192,49
I,1,120026,99,h,102,3
I,1,120128,174,a,117,-57
I,1,120245,77,p,124,47
I,1,120369,89,p,71,-18
I,1,120440,188,y,110,-78
I,1,120550,151,.,NA,NA
I,2,131,116,R,262,146
I,2,393,85,o,300,215
I,2,693,234,l,354,120
I,2,1047,105,l,87,-18
I,2,1134,176, ,79,-97
I,2,1213,165,p,87,-78
I,2,1300,144,a,82,-62
I,2,1382,182,r,120,-62
I,2,1502,145,a,89,-56
I,2,1591,166,t,44,-122
I,2,1635,151,h,109,-42
I,2,1744,184,a,33,-151
I,2,1777,205,s,4044,3839
I,2,5821,220,a,1610,1390
I,2,7431,201,S,160,-41
I,2,7591,102,h,210,108
I,2,7801,77,u,1096,1019
I,2,8897,174,a,1704,1530
I,2,10601,145,C,290,145
I,2,10891,171,r,94,-77
I,2,10985,182,a,1287,1105
I,2,12272,179,R,170,-9
I,2,12442,110,o,172,62
I,2,12614,80,l,147,67
I,2,12761,47,l,49,2
I,2,12810,134, ,110,-24
I,2,12920,152,p,76,-76
I,2,12996,107,a,56,-51
I,2,13052,160,r,111,-49
I,2,13163,148,a,120,-28
I,2,13283,149,t,109,-40
I,2,13392,171,h,71,-100
I,2,13463,205,a,129,-76
I,2,13592,176,s,153,-23
I,2,13745,163, ,82,-81
I,2,13827,170,a,87,-83
I,2,13914,144,r,29,-115
I,2,13943,166,e,119,-47
I,2,14062,98, ,72,-26
I,2,14134,185,a,105,-80
I,2,14239,116, ,98,-18
I,2,14337,151,b,159,8
I,2,14496,172,r,51,-121
I,2,14547,197,e,92,-105
I,2,14639,151,a,6,-145
I,2,14645,163,k,2510,2347
I,2,17155,150, ,65,-85
I,2,17220,226,n,72,-154
I,2,17292,200,i,462,262
I,2,17754,172,c,83,-89
I,2,17837,135,e,109,-26
I,2,17946,165, ,78,-87
I,2,18024,88,b,40,-48
I,2,18064,145,r,37,-108
I,2,18101,231,e,77,-154
I,2,18178,184,a,88,-96
I,2,18266,177,k,104,-73
I,2,18370,166, ,83,-83
I,2,18453,204,f,27,-177
I,2,18480,188,r,143,-45
I,2,18623,127,m,5,-122
I,2,18628,94,o,219,125
I,2,18847,171,b,1531,1360
I,2,20378,112,o,174,62
I,2,20552,106,m,2496,2390
I,2,23048,199,e,382,183
I,2,23430,161, ,1396,1235
I,2,24826,157,a,47,-110
I,2,24873,164, ,86,-78
I,2,24959,122,t,159,37
I,2,25118,134,y,54,-80
I,2,25172,113,p,104,-9
I,2,25276,166,e,84,-82
I,2,25360,143, ,115,-28
I,2,25475,135,o,31,-104
I,2,25506,144,f,122,-22
I,2,25628,134, ,109,-25
I,2,25737,133,P,208,75
I,2,25945,154,a,408,254
I,2,26353,171,k,55,-116
I,2,26408,150,i,88,-62
I,2,26496,154,s,109,-45
I,2,26605,158,t,61,-97
I,2,26666,199,a,71,-128
I,2,26737,195,n,45,-150
I,2,26782,186,i,209,23
I,2,26991,211, ,244,33
I,2,27235,172,f,214,42
I,2,27449,195,a,123,-72
I,2,27572,187,s,276,89
I,2,27848,105, ,288,183
I,2,28136,158,t,88,-70
I,2,28224,227, ,154,-73
I,2,28378,130,d,18,-112
I,2,28396,104,o,138,34
I,2,28534,133,o,93,-40
I,2,28627,228,d,943,715
I,2,29570,167,f,149,-18
I,2,29719,112,o,148,36
I,2,29867,106,o,67,-39
I,2,29934,147,d,137,-10
I,2,30071,184, ,60,-124
I,2,30131,150,t,61,-89
I,2,30192,137,h,109,-28
I,2,30301,168,a,53,-115
I,2,30354,136,t,85,-51
I,2,30439,145, ,60,-85
I,2,30499,145,p,449,304
I,2,30948,133,r,116,-17
I,2,31064,100,o,104,4
I,2,31168,134,v,72,-62
I,2,31240,138,i,159,21
I,2,31399,163,d,55,-108
I,2,31454,200,e,126,-74
I,2,31580,134, ,42,-92
I,2,31622,215,m,64,-151
I,2,31686,223,o,110,-113
I,2,31796,162,s,61,-101
I,2,31857,137,t,122,-15
I,2,31979,197, ,92,-105
I,2,32071,208,f,71,-137
I,2,32142,165,l,94,-71
I,2,32236,138,a,147,9
I,2,32383,215,v,155,-60
I,2,32538,220,o,94,-126
I,2,32632,247,r,5003,4756
I,2,37635,149, ,97,-52
I,2,37732,161,f,620,459
I,2,38352,161,a,60,-101
I,2,38412,184,s,116,-68
I,2,38528,162,t,148,-14
I,2,38676,170, ,67,-103
I,2,38743,144,f,93,-51
I,2,38836,77,o,115,38
I,2,38951,129,o,120,-9
I,2,39071,100,d,698,598
I,2,39769,184, ,112,-72
I,2,39881,136,t,31,-105
I,2,39912,135,h,126,-9
I,2,40038,252,a,57,-195
I,2,40095,166,t,368,202
I,2,40463,126, ,102,-24
I,2,40565,190,h,71,-119
I,2,40636,298,a,55,-243
I,2,40691,177,v,55,-122
I,2,40746,190,e,6726,6536
I,2,47472,149,P,174,25
I,2,47646,116,a,166,50
I,2,47812,161,k,385,224
I,2,48197,147,i,76,-71
I,2,48273,116,s,61,-55
I,2,48334,173,t,66,-107
I,2,48400,170,a,46,-124
I,2,48446,157,n,47,-110
I,2,48493,161,i,126,-35
I,2,48619,140, ,163,23
I,2,48782,152,f,44,-108
I,2,48826,90,o,103,13
I,2,48929,146,o,69,-77
I,2,48998,111,d,80,-31
I,2,49078,186, ,72,-114
I,2,49150,135,t,82,-53
I,2,49232,124,h,67,-57
I,2,49299,111,a,39,-72
I,2,49338,94,t,54,-40
I,2,49392,152, ,116,-36
I,2,49508,133,c,27,-106
I,2,49535,161,o,89,-72
I,2,49624,132,n,82,-50
I,2,49706,160,t,77,-83
I,2,49783,149,a,43,-106
I,2,49826,183,i,56,-127
I,2,49882,137,n,35,-102
I,2,49917,193, ,113,-80
I,2,50030,155,w,819,664
I,2,50849,156,e,115,-41
I,2,50964,152,v,143,-9
I,2,51107,179,e,90,-89
I,2,51197,141,r,193,52
I,2,51390,100,t,344,244
I,2,51734,116,y,138,22
I,2,51872,182,t,46,-136
I,2,51918,126,h,102,-24
I,2,52020,194,i,98,-96
I,2,52118,140,n,28,-112
I,2,52146,101,g,130,29
I,2,52276,139, ,77,-62
I,2,52353,147,y,45,-102
I,2,52398,160,o,64,-96
I,2,52462,146,u,28,-118
I,2,52490,149, ,101,-48
I,2,52591,177,w,75,-102
I,2,52666,99,o,38,-61
I,2,52704,121,u,116,-5
I,2,52820,160,l,110,-50
I,2,52930,133,d,55,-78
I,2,52985,161, ,62,-99
I,2,53047,192,w,55,-137
I,2,53102,215,a,71,-144
I,2,53173,155,n,109,-46
I,2,53282,138,t,66,-72
I,2,53348,137, ,44,-93
I,2,53392,183,i,83,-100
I,2,53475,128,n,82,-46
I,2,53557,138, ,204,66
I,2,53761,162,f,93,-69
I,2,53854,151,a,66,-85
I,2,53920,156,s,104,-52
I,2,54024,130,t,84,-46
I,2,54108,170, ,104,-66
I,2,54212,135,f,54,-81
I,2,54266,273,o,306,33
I,2,54572,98,o,30,-68
I,2,54602,161,d,3147,2986
I,2,57749,150,c,164,14
I,2,57913,152,a,66,-86
I,2,57979,157,r,62,-95
I,2,58041,99,b,104,5
I,2,58145,181,s,201,20
I,2,58346,97,",",521,424
I,2,58867,154, ,120,-34
I,2,58987,144,m,83,-61
I,2,59070,119,e,71,-48
I,2,59141,183,a,127,-56
I,2,59268,135,t,16,-119
I,2,59284,238,",",920,682
I,2,60204,220, ,88,-132
I,2,60292,166,s,105,-61
I,2,60397,242,a,66,-176
I,2,60463,170,u,88,-82
I,2,60551,225,c,88,-137
I,2,60639,214,e,103,-111
I,2,60742,141,",",3388,3247
I,2,64130,188, ,111,-77
I,2,64241,211,a,11,-200
I,2,64252,204,n,174,-30
I,2,64426,167,d,105,-62
I,2,64531,161, ,179,18
I,2,64710,87,r,48,-39
I,2,64758,100,g,653,553
I,2,65411,110,g,212,102
I,2,65623,133,r,78,-55
I,2,65701,99,e,71,-28
I,2,65772,160,a,86,-74
I,2,65858,174,s,44,-130
I,2,65902,183,e,27,-156
I,2,65929,210,.,294,84
I,2,66223,104, ,3176,3072
I,2,69399,144,Y,252,108
I,2,69651,151,o,173,22
I,2,69824,94, ,458,364
I,2,70282,121,u,67,-54
I,2,70349,185, ,38,-147
I,2,70387,159,s,60,-99
I,2,70447,147,h,132,-15
I,2,70579,149,o,82,-67
I,2,70661,124,u,157,33
I,2,70818,158,l,87,-71
I,2,70905,142,d,87,-55
I,2,70992,197, ,78,-119
I,2,71070,263,e,92,-171
I,2,71162,195,a,161,-34
I,2,71323,170,t,160,-10
I,2,71483,184, ,47,-137
I,2,71530,208,t,51,-157
I,2,71581,127,h,109,-18
I,2,71690,161,e,116,-45
I,2,71806,157,m,127,-30
I,2,71933,122, ,81,-41
I,2,72014,175,i,94,-81
I,2,72108,141,f,132,-9
I,2,72240,128, ,2409,2281
I,2,74649,177,i,72,-105
I,2,74721,177,n,122,-55
I,2,74843,123, ,215,92
I,2,75058,147,g,74,-73
I,2,75132,116,e,82,-34
I,2,75214,123,n,94,-29
I,2,75308,145,e,88,-57
I,2,75396,189,r,93,-96
I,2,75489,172,a,17,-155
I,2,75506,165,l,110,-55
I,2,75616,249,",",4033,3784
I,2,79649,228,l,142,-86
I,2,79791,229,.,3164,2935
I,2,82955,133,u,61,-72
I,2,83016,124, ,61,-63
I,2,83077,110,s,54,-56
I,2,83131,112,h,173,61
I,2,83304,89,o,32,-57
I,2,83336,133,u,149,16
I,2,83485,191,l,58,-133
I,2,83543,145,d,114,-31
I,2,83657,139, ,54,-85
I,2,83711,161,e,110,-51
I,2,83821,166,a,111,-55
I,2,83932,83,t,43,-40
I,2,83975,155, ,78,-77
I,2,84053,188,t,49,-139
I,2,84102,107,h,98,-9
I,2,84200,158,e,130,-28
I,2,84330,98,m,71,-27
I,2,84401,134, ,108,-26
I,2,84509,128,n,2808,2680
I,2,87317,88,Y,209,121
I,2,87526,177,o,72,-105
I,2,87598,126,u,166,40
I,2,87764,201, ,54,-147
I,2,87818,188,s,124,-64
I,2,87942,30,h,54,24
I,2,87996,134,o,72,-62
I,2,88068,123,u,163,40
I,2,88231,160,l,93,-67
I,2,88324,173,d,1795,1622
I,2,90119,205,T,231,26
I,2,90350,107,h,59,-48
I,2,90409,145,e,88,-57
I,2,90497,117,y,94,-23
I,2,90591,151,',104,-47
I,2,90695,123,r,39,-84
I,2,90734,162,e,132,-30
I,2,90866,133, ,66,-67
I,2,90932,200,c,82,-118
I,2,91014,117,h,77,-40
I,2,91091,234,e,83,-151
I,2,91174,191,a,60,-131
I,2,91234,195,p,100,-95
I,2,91334,171,",",137,-34
I,2,91471,176, ,94,-82
I,2,91565,117,q,39,-78
I,2,91604,142,u,52,-90
I,2,91656,142,i,134,-8
I,2,91790,193,c,72,-121
I,2,91862,112,k,178,66
I,2,92040,194,",",1830,1636
I,2,93870,141,e,100,-41
I,2,93970,167,a,362,195
I,2,94332,134,e,66,-68
I,2,94398,155,a,55,-100
I,2,94453,171,s,718,547
I,2,95171,133,e,43,-90
I,2,95214,134,a,43,-91
I,2,95257,154,s,161,7
I,2,95418,137,y,262,125
I,2,95680,111,u,188,77
I,2,95868,185,",",827,642
I,2,96695,109,y,868,759
I,2,97563,154,",",231,77
I,2,97794,172, ,99,-73
I,2,97893,117,q,32,-85
I,2,97925,156,u,46,-110
I,2,97971,155,i,171,16
I,2,98142,194,c,123,-71
I,2,98265,120,k,152,32
I,2,98417,189,",",294,105
I,2,98711,156, ,78,-78
I,2,98789,186,a,52,-134
I,2,98841,152,n,101,-51
I,2,98942,154,d,75,-79
I,2,99017,213, ,143,-70
I,2,99160,156,g,78,-78
I,2,99238,165,u,109,-56
I,2,99347,133,a,95,-38
I,2,99442,160,r,82,-78
I,2,99524,205,n,21,-184
I,2,99545,123,a,111,-12
I,2,99656,135,t,65,-70
I,2,99721,144,e,165,21
I,2,99886,135,e,1470,1335
I,2,101356,133,u,110,-23
I,2,101466,132,a,233,101
I,2,101699,106,r,406,300
I,2,102105,129,a,38,-91
I,2,102143,166,n,89,-77
I,2,102232,173,t,104,-69
I,2,102336,109,e,170,61
I,2,102506,102,e,159,57
I,2,102665,155,d,83,-72
I,2,102748,143, ,160,17
I,2,102908,100,g,110,10
I,2,103018,134,a,30,-104
I,2,103048,122,u,98,-24
I,2,103146,154,r,106,-48
I,2,103252,124,a,57,-67
I,2,103309,127,n,111,-16
I,2,103420,89,t,32,-57
I,2,103452,88,e,2268,2180
I,2,105720,161,t,48,-113
I,2,105768,128,o,118,-10
I,2,105886,137, ,72,-65
I,2,105958,110,m,48,-62
I,2,106006,123,a,109,-14
I,2,106115,106,k,24,-82
I,2,106139,160,e,91,-69
I,2,106230,159, ,67,-92
I,2,106297,156,y,19,-137
I,2,106316,228,o,96,-132
I,2,106412,123,u,67,-56
I,2,106479,138, ,61,-77
I,2,106540,156,w,54,-102
I,2,106594,189,a,72,-117
I,2,106666,140,n,84,-56
I,2,106750,132,t,77,-55
I,2,106827,135, ,42,-93
I,2,106869,135,m,55,-80
I,2,106924,90,o,28,-62
I,2,106952,102,r,49,-53
I,2,107001,113,e,51,-62
I,2,107052,183,.,NA,NA
J,1,168,144,F,168,24
J,1,336,168,a,136,-32
J,1,472,100,r,188,88
J,1,660,72, ,147,75
J,1,807,164,o,140,-24
J,1,947,84,u,184,100
J,1,1131,80,t,125,45
J,1,1256,80, ,186,106
J,1,1442,140,i,108,-32
J,1,1550,100,n,112,12
J,1,1662,60, ,147,87
J,1,1809,180,t,48,-132
J,1,1857,72,h,76,4
J,1,1933,100,e,56,-44
J,1,1989,68, ,950,882
J,1,2939,80,c,919,839
J,1,3858,120,u,139,19
J,1,3997,96,n,140,44
J,1,4137,80,c,102,22
J,1,4239,64,h,100,36
J,1,4339,136,a,80,-56
J,1,4419,112,r,232,120
J,1,4651,108,t,76,-32
J,1,4727,84,e,164,80
J,1,4891,100,d,104,4
J,1,4995,56, ,123,67
J,1,5118,100,b,96,-4
J,1,5214,116,a,124,8
J,1,5338,80,c,139,59
J,1,5477,80,k,169,89
J,1,5646,103,w,84,-19
J,1,5730,179,a,176,-3
J,1,5906,148,t,124,-24
J,1,6030,160,e,116,-44
J,1,6146,108,r,126,18
J,1,6272,104,s,121,17
J,1,6393,68, ,376,308
J,1,6769,96,o,113,17
J,1,6882,84,f,72,-12
J,1,6954,68, ,112,44
J,1,7066,180,t,56,-124
J,1,7122,72,h,52,-20
J,1,7174,104,e,60,-44
J,1,7234,60, ,205,145
J,1,7439,116,u,96,-20
J,1,7535,100,n,133,33
J,1,7668,88,f,145,57
J,1,7813,92,a,154,62
J,1,7967,104,s,139,35
J,1,8106,156,h,84,-72
J,1,8190,140,i,60,-80
J,1,8250,164,o,185,21
J,1,8435,76,n,115,39
J,1,8550,84,a,213,129
J,1,8763,80,b,128,48
J,1,8891,96,l,96,0
J,1,8987,96,e,148,52
J,1,9135,53, ,332,279
J,1,9467,76,e,98,22
J,1,9565,88,n,106,18
J,1,9671,80,d,83,3
J,1,9754,65, ,104,39
J,1,9858,83,o,67,-16
J,1,9925,84,f,68,-16
J,1,9993,64, ,116,52
J,1,10109,160,t,28,-132
J,1,10137,84,h,69,-15
J,1,10206,104,e,15,-89
J,1,10221,76, ,191,115
J,1,10412,232,w,208,-24
J,1,10620,96,e,146,50
J,1,10766,140,s,120,-20
J,1,10886,108,t,127,19
J,1,11013,124,e,88,-36
J,1,11101,96,r,214,118
J,1,11315,81,n,150,69
J,1,11465,68, ,187,119
J,1,11652,91,s,103,12
J,1,11755,112,p,165,53
J,1,11920,89,i,113,24
J,1,12033,107,r,95,-12
J,1,12128,44,a,71,27
J,1,12199,96,l,100,4
J,1,12299,60, ,503,443
J,1,12802,104,a,72,-32
J,1,12874,84,r,88,4
J,1,12962,128,m,104,-24
J,1,13066,72, ,114,42
J,1,13180,85,o,88,3
J,1,13268,81,f,48,-33
J,1,13316,77, ,124,47
J,1,13440,180,t,60,-120
J,1,13500,73,h,47,-26
J,1,13547,124,e,226,102
J,1,13773,112, ,396,284
J,1,14169,96,G,175,79
J,1,14344,72,a,68,-4
J,1,14412,84,l,96,12
J,1,14508,84,a,212,128
J,1,14720,63,z,415,352
J,1,15135,132,x,260,128
J,1,15395,49,y,240,191
J,1,15635,60, ,487,427
J,1,16122,127,l,115,-12
J,1,16237,104,i,149,45
J,1,16386,51,e,134,83
J,1,16520,85,s,85,0
J,1,16605,72, ,194,122
J,1,16799,88,a,310,222
J,1,17109,78, ,200,122
J,1,17309,108,s,167,59
J,1,17476,104,m,116,12
J,1,17592,76,a,120,44
J,1,17712,63,l,125,62
J,1,17837,88,l,101,13
J,1,17938,63, ,349,286
J,1,18287,132,u,108,-24
J,1,18395,112,n,190,78
J,1,18585,155,r,83,-72
J,1,18668,128,e,124,-4
J,1,18792,213,g,128,-85
J,1,18920,125,r,96,-29
J,1,19016,132,a,573,441
J,1,19589,120,a,64,-56
J,1,19653,124,r,282,158
J,1,19935,195,d,131,-64
J,1,20066,133,e,104,-29
J,1,20170,132,d,116,-16
J,1,20286,84, ,304,220
J,1,20590,93,y,118,25
J,1,20708,72,e,117,45
J,1,20825,60,l,114,54
J,1,20939,76,l,149,73
J,1,21088,88,o,56,-32
J,1,21144,89,w,113,24
J,1,21257,72, ,121,49
J,1,21378,92,s,181,89
J,1,21559,80,u,159,79
J,1,21718,65,n,195,130
J,1,21913,64,.,106,42
J,1,22019,56, ,479,423
J,1,22498,93,O,248,155
J,1,22746,145,r,153,8
J,1,22899,87,b,176,89
J,1,23075,93,i,101,8
J,1,23176,92,t,475,383
J,1,23651,156,i,120,-36
J,1,23771,121,n,100,-21
J,1,23871,85,g,110,25
J,1,23981,64, ,105,41
J,1,24086,132,t,56,-76
J,1,24142,128,h,128,0
J,1,24270,104,i,80,-24
J,1,24350,104,s,112,8
J,1,24462,56, ,322,266
J,1,24784,109,a,68,-41
J,1,24852,88,t,106,18
J,1,24958,64, ,148,84
J,1,25106,80,a,92,12
J,1,25198,80, ,140,60
J,1,25338,105,d,105,0
J,1,25443,107,i,134,27
J,1,25577,136,s,128,-8
J,1,25705,104,t,104,0
J,1,25809,85,a,88,3
J,1,25897,144,n,225,81
J,1,26122,107,c,63,-44
J,1,26185,127,e,124,-3
J,1,26309,72, ,114,42
J,1,26423,80,o,56,-24
J,1,26479,92,f,80,-12
J,1,26559,72, ,327,255
J,1,26886,88,r,85,-3
J,1,26971,114,o,67,-47
J,1,27038,107,u,104,-3
J,1,27142,84,g,103,19
J,1,27245,79,h,110,31
J,1,27355,88,l,194,106
J,1,27549,68,y,111,43
J,1,27660,56, ,1229,1173
J,1,28889,127,n,104,-23
J,1,28993,143,i,117,-26
J,1,29110,99,n,132,33
J,1,29242,112,e,190,78
J,1,29432,96,t,365,269
J,1,29797,56,y,438,382
J,1,30235,76,t,247,171
J,1,30482,96,w,241,145
J,1,30723,100,o,173,73
J,1,30896,59, ,153,94
J,1,31049,88,m,120,32
J,1,31169,135,i,100,-35
J,1,31269,63,l,120,57
J,1,31389,98,l,153,55
J,1,31542,207,i,79,-128
J,1,31621,152,o,108,-44
J,1,31729,120,n,104,-16
J,1,31833,73, ,135,62
J,1,31968,116,m,105,-11
J,1,32073,143,i,119,-24
J,1,32192,125,l,165,40
J,1,32357,84,e,144,60
J,1,32501,104,s,80,-24
J,1,32581,72, ,94,22
J,1,32675,133,i,144,11
J,1,32819,85,s,127,42
J,1,32946,76, ,97,21
J,1,33043,88,a,136,48
J,1,33179,100,n,202,102
J,1,33381,72, ,170,98
J,1,33551,124,u,249,125
J,1,33800,64,t,135,71
J,1,33935,84,t,76,-8
J,1,34011,136,e,96,-40
J,1,34107,96,r,96,0
J,1,34203,88,l,220,132
J,1,34423,68,y,110,42
J,1,34533,55, ,127,72
J,1,34660,116,i,211,95
J,1,34871,64,n,115,51
J,1,34986,102,s,236,134
J,1,35222,104,i,123,19
J,1,35345,96,g,154,58
J,1,35499,120,n,120,0
J,1,35619,112,i,135,23
J,1,35754,84,f,112,28
J,1,35866,97,i,138,41
J,1,36004,119,c,99,-20
J,1,36103,76,a,80,4
J,1,36183,84,n,110,26
J,1,36293,95,t,115,20
J,1,36408,57, ,215,158
J,1,36623,112,l,92,-20
J,1,36715,100,i,112,12
J,1,36827,56,t,140,84
J,1,36967,95,t,113,18
J,1,37080,95,l,219,124
J,1,37299,104,e,150,46
J,1,37449,80, ,287,207
J,1,37736,88,b,129,41
J,1,37865,92,l,217,125
J,1,38082,67,u,87,20
J,1,38169,104,e,92,-12
J,1,38261,80, ,255,175
J,1,38516,184,g,104,-80
J,1,38620,160,r,92,-68
J,1,38712,92,e,154,62
J,1,38866,81,e,200,119
J,1,39066,104,n,148,44
J,1,39214,73, ,161,88
J,1,39375,92,p,199,107
J,1,39574,76,l,125,49
J,1,39699,80,a,110,30
J,1,39809,72,n,121,49
J,1,39930,88,e,262,174
J,1,40192,87,t,105,18
J,1,40297,67, ,100,33
J,1,40397,108,w,116,8
J,1,40513,136,h,68,-68
J,1,40581,124,o,268,144
J,1,40849,168,s,104,-64
J,1,40953,104,e,122,18
J,1,41075,56, ,175,119
J,1,41250,79,a,202,123
J,1,41452,91,p,164,73
J,1,41616,108,e,438,330
J,1,42054,120,d,337,217
J,1,42391,96,e,165,69
J,1,42556,176,s,176,0
J,1,42732,152,c,108,-44
J,1,42840,120,e,167,47
J,1,43007,88,n,158,70
J,1,43165,176,d,116,-60
J,1,43281,136,e,128,-8
J,1,43409,97,d,690,593
J,1,44099,72, ,434,362
J,1,44533,97,i,516,419
J,1,45049,107,l,92,-15
J,1,45141,104,i,104,0
J,1,45245,136,f,80,-56
J,1,45325,109,e,85,-24
J,1,45410,63, ,94,31
J,1,45504,104,f,135,31
J,1,45639,92,o,85,-7
J,1,45724,100,r,123,23
J,1,45847,80,m,104,24
J,1,45951,108,s,138,30
J,1,46089,60, ,88,28
J,1,46177,116,a,81,-35
J,1,46258,151,r,88,-63
J,1,46346,91,e,103,12
J,1,46449,64, ,83,19
J,1,46532,109,s,96,-13
J,1,46628,116,o,108,-8
J,1,46736,64, ,132,68
J,1,46868,83,a,127,44
J,1,46995,68,m,87,19
J,1,47082,80,a,303,223
J,1,47385,99,x,172,73
J,1,47557,136,i,93,-43
J,1,47650,107,n,75,-32
J,1,47725,88,g,135,47
J,1,47860,92,l,1079,987
J,1,48939,80,z,291,211
J,1,49230,160,i,116,-44
J,1,49346,100,n,97,-3
J,1,49443,67,g,101,34
J,1,49544,93,l,202,109
J,1,49746,56,y,110,54
J,1,49856,44, ,269,225
J,1,50125,88,p,247,159
J,1,50372,108,r,197,89
J,1,50569,156,i,132,-24
J,1,50701,164,m,136,-28
J,1,50837,149,i,185,36
J,1,51022,108,t,187,79
J,1,51209,101,i,194,93
J,1,51403,192,v,121,-71
J,1,51524,111,e,109,-2
J,1,51633,74, ,107,33
J,1,51740,92,t,48,-44
J,1,51788,80,h,60,-20
J,1,51848,112,a,84,-28
J,1,51932,76,t,48,-28
J,1,51980,84, ,113,29
J,1,52093,173,t,25,-148
J,1,52118,99,h,75,-24
J,1,52193,120,e,128,8
J,1,52321,72,y,100,28
J,1,52421,60, ,171,111
J,1,52592,108,s,221,113
J,1,52813,96,t,104,8
J,1,52917,153,i,105,-48
J,1,53022,87,l,145,58
J,1,53167,88,l,84,-4
J,1,53251,60, ,78,18
J,1,53329,101,t,108,7
J,1,53437,124,h,84,-40
J,1,53521,154,i,129,-25
J,1,53650,152,n,100,-52
J,1,53750,123,k,185,62
J,1,53935,72, ,208,136
J,1,54143,116,d,112,-4
J,1,54255,88,i,100,12
J,1,54355,80,g,116,36
J,1,54471,96,i,124,28
J,1,54595,124,t,84,-40
J,1,54679,104,a,100,-4
J,1,54779,89,l,81,-8
J,1,54860,67, ,421,354
J,1,55281,140,w,104,-36
J,1,55385,128,a,112,-16
J,1,55497,84,t,251,167
J,1,55748,72,c,100,28
J,1,55848,88,h,84,-4
J,1,55932,72,e,147,75
J,1,56079,108,s,111,3
J,1,56190,73, ,93,20
J,1,56283,128,a,92,-36
J,1,56375,152,r,77,-75
J,1,56452,111,e,75,-36
J,1,56527,88, ,111,23
J,1,56638,84,a,106,22
J,1,56744,72, ,128,56
J,1,56872,111,p,103,-8
J,1,56975,152,r,72,-80
J,1,57047,144,e,193,49
J,1,57240,80,t,160,80
J,1,57400,92,t,222,130
J,1,57622,92,y,128,36
J,1,57750,52, ,161,109
J,1,57911,75,n,153,78
J,1,58064,100,e,373,273
J,1,58437,104,a,64,-40
J,1,58501,80,t,114,34
J,1,58615,56, ,321,265
J,1,58936,64, ,1079,1015
J,1,60015,88, ,449,361
J,1,60464,104,i,145,41
J,1,60609,251,d,120,-131
J,1,60729,135,e,128,-7
J,1,60857,55,a,130,75
J,1,60987,112,.,104,-8
J,1,61091,76, ,4345,4269
J,1,65436,108,T,88,-20
J,1,65524,136,h,68,-68
J,1,65592,104,i,60,-44
J,1,65652,108,s,100,-8
J,1,65752,72, ,715,643
J,1,66467,88,p,181,93
J,1,66648,88,l,118,30
J,1,66766,92,a,129,37
J,1,66895,60,n,226,166
J,1,67121,160,e,132,-28
J,1,67253,108,t,172,64
J,1,67425,56, ,133,77
J,1,67558,80,h,92,12
J,1,67650,136,a,88,-48
J,1,67738,128,s,156,28
J,1,67894,96,",",92,-4
J,1,67986,52, ,135,83
J,1,68121,92,o,144,52
J,1,68265,104,r,177,73
J,1,68442,76, ,143,67
J,1,68585,124,r,146,22
J,1,68731,132,a,68,-64
J,1,68799,104,t,131,27
J,1,68930,100,h,117,17
J,1,69047,160,e,96,-64
J,1,69143,112,r,144,32
J,1,69287,56, ,162,106
J,1,69449,80,h,117,37
J,1,69566,112,a,157,45
J,1,69723,112,d,152,40
J,1,69875,108,",",92,-16
J,1,69967,77, ,88,11
J,1,70055,92,a,110,18
J,1,70165,59, ,148,89
J,1,70313,104,p,116,12
J,1,70429,128,r,112,-16
J,1,70541,76,o,194,118
J,1,70735,87,b,142,55
J,1,70877,99,l,91,-8
J,1,70968,89,e,299,210
J,1,71267,108,m,417,309
J,1,71684,109,",",167,58
J,1,71851,64, ,140,76
J,1,71991,92,w,80,-12
J,1,72071,120,h,64,-56
J,1,72135,108,i,100,-8
J,1,72235,101,c,80,-21
J,1,72315,108,h,108,0
J,1,72423,60, ,117,57
J,1,72540,84,w,72,-12
J,1,72612,136,a,84,-52
J,1,72696,109,s,109,0
J,1,72805,64, ,112,48
J,1,72917,80,t,44,-36
J,1,72961,112,h,53,-59
J,1,73014,115,i,103,-12
J,1,73117,100,s,229,129
J,1,73346,96,:,132,36
J,1,73478,60, ,458,398
J,1,73936,113,m,72,-41
J,1,74008,105,o,108,3
J,1,74116,112,s,60,-52
J,1,74176,104,t,92,-12
J,1,74268,60, ,110,50
J,1,74378,92,o,104,12
J,1,74482,104,f,130,26
J,1,74612,64, ,64,0
J,1,74676,229,t,96,-133
J,1,74772,120,h,40,-80
J,1,74812,136,e,140,4
J,1,74952,75, ,173,98
J,1,75125,88,p,328,240
J,1,75453,96,e,109,13
J,1,75562,144,o,76,-68
J,1,75638,117,p,191,74
J,1,75829,88,l,88,0
J,1,75917,92,e,76,-16
J,1,75993,68, ,159,91
J,1,76152,144,o,96,-48
J,1,76248,113,n,92,-21
J,1,76340,61, ,103,42
J,1,76443,100,i,92,-8
J,1,76535,73,t,76,3
J,1,76611,88, ,107,19
J,1,76718,92,w,307,215
J,1,77025,168,r,120,-48
J,1,77145,160,e,136,-24
J,1,77281,124,r,136,12
J,1,77417,84, ,386,302
J,1,77803,92,u,1186,1094
J,1,78989,136,e,88,-48
J,1,79077,192,r,108,-84
J,1,79185,124,e,170,46
J,1,79355,75, ,307,232
J,1,79662,128,u,149,21
J,1,79811,92,n,250,158
J,1,80061,84,h,96,12
J,1,80157,72,a,117,45
J,1,80274,68,p,124,56
J,1,80398,80,p,215,135
J,1,80613,60,y,114,54
J,1,80727,51, ,136,85
J,1,80863,112,m,84,-28
J,1,80947,80,o,742,662
J,1,81689,104,f,131,27
J,1,81820,88,o,109,21
J,1,81929,84,r,92,8
J,1,82021,68, ,377,309
J,1,82398,104,p,116,12
J,1,82514,176,r,101,-75
J,1,82615,111,e,200,89
J,1,82815,64,t,141,77
J,1,82956,72,t,61,-11
J,1,83017,91,y,117,26
J,1,83134,56, ,119,63
J,1,83253,100,m,278,178
J,1,83531,85,u,158,73
J,1,83689,87,c,79,-8
J,1,83768,120,h,92,-28
J,1,83860,81, ,759,678
J,1,84619,57,o,120,63
J,1,84739,132,f,163,31
J,1,84902,72, ,101,29
J,1,85003,236,t,124,-112
J,1,85127,88,h,13,-75
J,1,85140,135,e,165,30
J,1,85305,76, ,101,25
J,1,85406,120,t,72,-48
J,1,85478,128,i,92,-36
J,1,85570,120,m,92,-28
J,1,85662,120,e,108,-12
J,1,85770,116,.,104,-12
J,1,85874,80, ,427,347
J,1,86301,104,M,197,93
J,1,86498,72,a,65,-7
J,1,86563,75,n,194,119
J,1,86757,76,y,103,27
J,1,86860,60, ,84,24
J,1,86944,92,s,112,20
J,1,87056,100,o,191,91
J,1,87247,88,l,260,172
J,1,87507,80,u,129,49
J,1,87636,96,t,92,-4
J,1,87728,176,i,40,-136
J,1,87768,172,o,116,-56
J,1,87884,96,n,80,-16
J,1,87964,112,s,150,38
J,1,88114,72, ,89,17
J,1,88203,140,w,76,-64
J,1,88279,112,e,189,77
J,1,88468,104,r,40,-64
J,1,88508,116,e,112,-4
J,1,88620,84, ,113,29
J,1,88733,100,e,424,324
J,1,89157,95,s,122,27
J,1,89279,57,u,110,53
J,1,89389,76,g,168,92
J,1,89557,168,g,136,-32
J,1,89693,124,e,192,68
J,1,89885,108,s,88,-20
J,1,89973,128,t,116,-12
J,1,90089,104,e,173,69
J,1,90262,92,d,92,0
J,1,90354,64, ,101,37
J,1,90455,97,f,113,16
J,1,90568,105,o,127,22
J,1,90695,108,r,164,56
J,1,90859,84, ,97,13
J,1,90956,90,t,83,-7
J,1,91039,112,h,56,-56
J,1,91095,108,i,56,-52
J,1,91151,103,s,125,22
J,1,91276,44, ,72,28
J,1,91348,92,p,69,-23
J,1,91417,103,r,154,51
J,1,91571,71,o,64,-7
J,1,91635,80,b,111,31
J,1,91746,92,l,88,-4
J,1,91834,104,e,137,33
J,1,91971,81,m,223,142
J,1,92194,100,",",108,8
J,1,92302,60, ,87,27
J,1,92389,96,b,122,26
J,1,92511,84,u,92,8
J,1,92603,84,t,88,4
J,1,92691,80, ,373,293
J,1,93064,116,m,80,-36
J,1,93144,104,o,154,50
J,1,93298,124,s,100,-24
J,1,93398,100,t,117,17
J,1,93515,64, ,82,18
J,1,93597,88,o,52,-36
J,1,93649,96,f,118,22
J,1,93767,77, ,72,-5
J,1,93839,120,t,392,272
J,1,94231,99,h,156,57
J,1,94387,68,e,175,107
J,1,94562,131,s,83,-48
J,1,94645,128,e,160,32
J,1,94805,56, ,56,0
J,1,94861,203,w,143,-60
J,1,95004,120,e,207,87
J,1,95211,128,r,56,-72
J,1,95267,120,e,120,0
J,1,95387,36, ,92,56
J,1,95479,96,l,184,88
J,1,95663,48,i,423,375
J,1,96086,128,a,64,-64
J,1,96150,152,r,96,-56
J,1,96246,132,g,157,25
J,1,96403,128,e,120,-8
J,1,96523,80,l,208,128
J,1,96731,68,y,145,77
J,1,96876,64, ,275,211
J,1,97151,75,c,75,0
J,1,97226,125,o,94,-31
J,1,97320,98,n,280,182
J,1,97600,96,c,68,-28
J,1,97668,145,e,97,-48
J,1,97765,103,r,129,26
J,1,97894,76,n,138,62
J,1,98032,88,e,171,83
J,1,98203,104,d,116,12
J,1,98319,72, ,89,17
J,1,98408,84,w,68,-16
J,1,98476,84,i,120,36
J,1,98596,91,t,80,-11
J,1,98676,92,h,153,61
J,1,98829,276,t,68,-208
J,1,98897,112, ,1053,941
J,1,99950,84, ,119,35
J,1,100069,116,t,92,-24
J,1,100161,96,h,92,-4
J,1,100253,112,e,108,-4
J,1,100361,72, ,129,57
J,1,100490,128,m,84,-44
J,1,100574,96,o,146,50
J,1,100720,148,v,104,-44
J,1,100824,100,e,72,-28
J,1,100896,92,m,111,19
J,1,101007,104,e,116,12
J,1,101123,76,n,60,-16
J,1,101183,160,t,128,-32
J,1,101311,88,d,601,513
J,1,101912,108,s,134,26
J,1,102046,68, ,128,60
J,1,102174,100,o,88,-12
J,1,102262,100,f,104,4
J,1,102366,56, ,60,4
J,1,102426,133,s,162,29
J,1,102588,107,m,104,-3
J,1,102692,100,a,131,31
J,1,102823,69,l,132,63
J,1,102955,96,l,96,0
J,1,103051,56, ,156,100
J,1,103207,188,g,105,-83
J,1,103312,172,r,87,-85
J,1,103399,112,e,180,68
J,1,103579,125,e,77,-48
J,1,103656,124,n,127,3
J,1,103783,61, ,85,24
J,1,103868,84,p,410,326
J,1,104278,108,i,108,0
J,1,104386,167,e,171,4
J,1,104557,157,c,104,-53
J,1,104661,120,e,167,47
J,1,104828,124,s,136,12
J,1,104964,56, ,86,30
J,1,105050,100,o,125,25
J,1,105175,112,f,96,-16
J,1,105271,72, ,126,54
J,1,105397,108,p,105,-3
J,1,105502,84,a,135,51
J,1,105637,100,p,104,4
J,1,105741,108,e,68,-40
J,1,105809,112,r,139,27
J,1,105948,96,",",89,-7
J,1,106037,59, ,59,0
J,1,106096,104,w,116,12
J,1,106212,128,h,72,-56
J,1,106284,112,i,80,-32
J,1,106364,96,c,100,4
J,1,106464,104,h,84,-20
J,1,106548,72, ,139,67
J,1,106687,96,i,56,-40
J,1,106743,116,s,113,-3
J,1,106856,63, ,241,178
J,1,107097,76,o,117,41
J,1,107214,80,d,148,68
J,1,107362,92,d,206,114
J,1,107568,64, ,155,91
J,1,107723,128,b,80,-48
J,1,107803,104,e,169,65
J,1,107972,100,c,68,-32
J,1,108040,80,a,102,22
J,1,108142,89,u,89,0
J,1,108231,119,s,71,-48
J,1,108302,104,e,73,-31
J,1,108375,63, ,555,492
J,1,108930,156,o,120,-36
J,1,109050,112,n,221,109
J,1,109271,136,t,588,452
J,1,109859,96, ,153,57
J,1,110012,200,t,92,-108
J,1,110104,84,h,64,-20
J,1,110168,120,e,104,-16
J,1,110272,68, ,286,218
J,1,110558,111,w,91,-20
J,1,110649,121,h,49,-72
J,1,110698,115,o,187,72
J,1,110885,104,l,101,-3
J,1,110986,88,e,88,0
J,1,111074,67, ,108,41
J,1,111182,92,i,104,12
J,1,111286,80,t,119,39
J,1,111405,68, ,101,33
J,1,111506,119,w,99,-20
J,1,111605,160,a,92,-68
J,1,111697,104,s,180,76
J,1,111877,68,n,418,350
J,1,112295,88,',143,55
J,1,112438,120,t,96,-24
J,1,112534,72, ,432,360
J,1,112966,128,t,84,-44
J,1,113050,88,h,80,-8
J,1,113130,128,e,92,-36
J,1,113222,72, ,134,62
J,1,113356,124,s,112,-12
J,1,113468,92,m,122,30
J,1,113590,104,a,220,116
J,1,113810,68,l,131,63
J,1,113941,104,l,142,38
J,1,114083,80, ,208,128
J,1,114291,196,g,92,-104
J,1,114383,188,r,108,-80
J,1,114491,96,e,178,82
J,1,114669,139,e,91,-48
J,1,114760,116,n,108,-8
J,1,114868,64, ,136,72
J,1,115004,88,p,637,549
J,1,115641,80,e,522,442
J,1,116163,96,i,52,-44
J,1,116215,136,e,124,-12
J,1,116339,173,c,104,-69
J,1,116443,117,e,185,68
J,1,116628,112,s,129,17
J,1,116757,72, ,84,12
J,1,116841,108,o,92,-16
J,1,116933,112,f,88,-24
J,1,117021,56, ,99,43
J,1,117120,108,p,108,0
J,1,117228,191,a,302,111
J,1,117530,96,p,83,-13
J,1,117613,141,e,93,-48
J,1,117706,96,r,116,20
J,1,117822,52, ,127,75
J,1,117949,96,t,122,26
J,1,118071,107,h,156,49
J,1,118227,156,a,92,-64
J,1,118319,100,t,123,23
J,1,118442,56, ,115,59
J,1,118557,156,w,92,-64
J,1,118649,93,e,181,88
J,1,118830,120,r,52,-68
J,1,118882,120,e,128,8
J,1,119010,65, ,244,179
J,1,119254,109,u,112,3
J,1,119366,92,n,307,215
J,1,119673,92,h,143,51
J,1,119816,68,a,106,38
J,1,119922,56,p,118,62
J,1,120040,80,p,207,127
J,1,120247,60,y,313,253
J,1,120560,76,.,NA,NA
J,2,721,122,I,141,19
J,2,862,80, ,3183,3103
J,2,4045,91,M,227,136
J,2,4272,72,y,119,47
J,2,4391,72, ,109,37
J,2,4500,100,f,56,-44
J,2,4556,124,a,220,96
J,2,4776,85,v,109,24
J,2,4885,57,o,135,78
J,2,5020,92,t,92,0
J,2,5112,80,i,207,127
J,2,5319,199,r,119,-80
J,2,5438,101,e,685,584
J,2,6123,96,r,137,41
J,2,6260,76,i,68,-8
J,2,6328,132,t,80,-52
J,2,6408,120,e,80,-40
J,2,6488,68, ,114,46
J,2,6602,64,f,84,20
J,2,6686,53,o,125,72
J,2,6811,89,o,89,0
J,2,6900,107,d,111,4
J,2,7011,68, ,175,107
J,2,7186,60,i,91,31
J,2,7277,80,s,84,4
J,2,7361,60, ,771,711
J,2,8132,107,q,199,92
J,2,8331,132,u,72,-60
J,2,8403,108,i,959,851
J,2,9362,80,c,136,56
J,2,9498,79,h,59,-20
J,2,9557,64,e,3191,3127
J,2,12748,92,t,128,36
J,2,12876,92,o,165,73
J,2,13041,76,m,150,74
J,2,13191,124,e,771,647
J,2,13962,147,a,99,-48
J,2,14061,100,t,138,38
J,2,14199,85,o,167,82
J,2,14366,73, ,192,119
J,2,14558,172,f,108,-64
J,2,14666,164,e,161,-3
J,2,14827,139,t,119,-20
J,2,14946,108,a,116,8
J,2,15062,68, ,220,152
J,2,15282,136,t,80,-56
J,2,15362,172,a,156,-16
J,2,15518,88,r,207,119
J,2,15725,85,t,182,97
J,2,15907,100,.,105,5
J,2,16012,70, ,142,72
J,2,16154,157,T,5,-152
J,2,16159,100,I,334,234
J,2,16493,72, ,733,661
J,2,17226,83,I,121,38
J,2,17347,84,t,72,-12
J,2,17419,76, ,1074,998
J,2,18493,79,i,115,36
J,2,18608,48,s,79,31
J,2,18687,76, ,1574,1498
J,2,20261,103,W,48,-55
J,2,20309,104,e,156,52
J,2,20465,92,',206,114
J,2,20671,104,d,122,18
J,2,20793,63, ,171,108
J,2,20964,69,h,72,3
J,2,21036,140,a,120,-20
J,2,21156,140,v,85,-55
J,2,21241,115,e,79,-36
J,2,21320,64, ,133,69
J,2,21453,79,i,67,-12
J,2,21520,104,t,92,-12
J,2,21612,76, ,76,0
J,2,21688,96,a,122,26
J,2,21810,56, ,141,85
J,2,21951,35,l,131,96
J,2,22082,68,o,84,16
J,2,22166,89,t,89,0
J,2,22255,68, ,136,68
J,2,22391,107,w,107,0
J,2,22498,76,h,119,43
J,2,22617,112,e,81,-31
J,2,22698,95,n,98,3
J,2,22796,60, ,150,90
J,2,22946,80,I,72,-8
J,2,23018,64, ,92,28
J,2,23110,131,w,695,564
J,2,23805,131,a,79,-52
J,2,23884,80,s,77,-3
J,2,23961,83, ,322,239
J,2,24283,80,l,133,53
J,2,24416,68,i,106,38
J,2,24522,48,t,128,80
J,2,24650,85,t,80,-5
J,2,24730,93,l,104,11
J,2,24834,80,e,92,12
J,2,24926,76, ,109,33
J,2,25035,92,a,72,-20
J,2,25107,84,n,84,0
J,2,25191,100,d,96,-4
J,2,25287,64, ,134,70
J,2,25421,91,h,111,20
J,2,25532,92,a,104,12
J,2,25636,112,d,141,29
J,2,25777,60, ,256,196
J,2,26033,88,c,68,-20
J,2,26101,121,h,72,-49
J,2,26173,114,i,114,0
J,2,26287,79,c,145,66
J,2,26432,84,k,102,18
J,2,26534,116,e,263,147
J,2,26797,83,n,79,-4
J,2,26876,89,s,515,426
J,2,27391,84,",",96,12
J,2,27487,76, ,169,93
J,2,27656,157,b,101,-56
J,2,27757,123,e,195,72
J,2,27952,84,c,76,-8
J,2,28028,40,a,85,45
J,2,28113,72,u,80,8
J,2,28193,100,s,57,-43
J,2,28250,107,e,67,-40
J,2,28317,72, ,141,69
J,2,28458,92,i,71,-21
J,2,28529,88,t,85,-3
J,2,28614,75, ,153,78
J,2,28767,51,a,59,8
J,2,28826,76,i,601,525
J,2,29427,59,i,47,-12
J,2,29474,72,s,84,12
J,2,29558,96, ,120,24
J,2,29678,88,a,84,-4
J,2,29762,72, ,99,27
J,2,29861,96,g,113,17
J,2,29974,80,o,97,17
J,2,30071,108,o,183,75
J,2,30254,57,o,504,447
J,2,30758,88,d,60,-28
J,2,30818,88, ,231,143
J,2,31049,144,w,84,-60
J,2,31133,120,a,112,-8
J,2,31245,64,y,110,46
J,2,31355,80, ,130,50
J,2,31485,124,t,8,-116
J,2,31493,108,r,56,-52
J,2,31549,80,o,129,49
J,2,31678,52, ,728,676
J,2,32406,68,o,230,162
J,2,32636,72, ,132,60
J,2,32768,156,g,103,-53
J,2,32871,168,e,97,-71
J,2,32968,119,t,108,-11
J,2,33076,67, ,245,178
J,2,33321,100,r,109,9
J,2,33430,79,i,139,60
J,2,33569,99,d,163,64
J,2,33732,68, ,138,70
J,2,33870,88,o,96,8
J,2,33966,96,f,88,-8
J,2,34054,72, ,124,52
J,2,34178,97,a,134,37
J,2,34312,64, ,126,62
J,2,34438,92,l,178,86
J,2,34616,80,o,84,4
J,2,34700,84,t,84,0
J,2,34784,76, ,107,31
J,2,34891,96,o,100,4
J,2,34991,96,f,72,-24
J,2,35063,88, ,145,57
J,2,35208,156,e,140,-16
J,2,35348,68,g,161,93
J,2,35509,104,g,84,-20
J,2,35593,108,s,108,0
J,2,35701,96,.,81,-15
J,2,35782,55, ,156,101
J,2,35938,165,t,116,-49
J,2,36054,72,h,49,-23
J,2,36103,247,e,155,-92
J,2,36258,176,r,1102,926
J,2,37360,132,W,73,-59
J,2,37433,111,e,115,4
J,2,37548,76, ,156,80
J,2,37704,112,w,68,-44
J,2,37772,100,o,72,-28
J,2,37844,148,u,124,-24
J,2,37968,92,l,104,12
J,2,38072,79,d,52,-27
J,2,38124,68, ,940,872
J,2,39064,96,o,2396,2300
J,2,41460,120,Y,92,-28
J,2,41552,124,o,76,-48
J,2,41628,84,u,84,0
J,2,41712,43, ,209,166
J,2,41921,113,m,92,-21
J,2,42013,80,i,238,158
J,2,42251,47,x,396,349
J,2,42647,84, ,159,75
J,2,42806,196,t,56,-140
J,2,42862,101,h,77,-24
J,2,42939,135,e,79,-56
J,2,43018,64, ,142,78
J,2,43160,176,e,156,-20
J,2,43316,100,g,196,96
J,2,43512,132,g,151,19
J,2,43663,120,s,132,12
J,2,43795,68, ,95,27
J,2,43890,100,w,64,-36
J,2,43954,92,i,100,8
J,2,44054,97,t,105,8
J,2,44159,99,h,83,-16
J,2,44242,88, ,1556,1468
J,2,45798,127,f,91,-36
J,2,45889,164,e,136,-28
J,2,46025,164,t,116,-48
J,2,46141,104,a,153,49
J,2,46294,80, ,125,45
J,2,46419,73,a,84,11
J,2,46503,88,n,96,8
J,2,46599,92,d,80,-12
J,2,46679,68, ,158,90
J,2,46837,136,m,117,-19
J,2,46954,191,i,127,-64
J,2,47081,100,l,248,148
J,2,47329,72,k,239,167
J,2,47568,60, ,190,130
J,2,47758,128,a,173,45
J,2,47931,89,n,100,11
J,2,48031,112,d,108,-4
J,2,48139,64, ,87,23
J,2,48226,120,s,109,-11
J,2,48335,95,p,161,66
J,2,48496,90,i,187,97
J,2,48683,132,c,76,-56
J,2,48759,89,e,175,86
J,2,48934,117,s,1786,1669
J,2,50720,88,",",123,35
J,2,50843,60, ,150,90
J,2,50993,84,t,127,43
J,2,51120,80,o,370,290
J,2,51490,72,p,246,174
J,2,51736,76, ,179,103
J,2,51915,276,t,133,-143
J,2,52048,83,h,99,16
J,2,52147,108,e,803,695
J,2,52950,51,i,97,46
J,2,53047,79,t,67,-12
J,2,53114,84, ,120,36
J,2,53234,120,w,96,-24
J,2,53330,92,i,114,22
J,2,53444,92,t,100,8
J,2,53544,88,h,100,12
J,2,53644,79, ,128,49
J,2,53772,124,t,116,-8
J,2,53888,104,o,824,720
J,2,54712,104,m,193,89
J,2,54905,136,a,92,-44
J,2,54997,100,t,208,108
J,2,55205,96,o,214,118
J,2,55419,84,e,164,80
J,2,55583,120,s,124,4
J,2,55707,96,",",92,-4
J,2,55799,68, ,151,83
J,2,55950,88,a,84,-4
J,2,56034,68,n,118,50
J,2,56152,108,d,100,-8
J,2,56252,64, ,123,59
J,2,56375,112,p,191,79
J,2,56566,72,u,95,23
J,2,56661,96,t,165,69
J,2,56826,76, ,271,195
J,2,57097,228,t,84,-144
J,2,57181,88,h,60,-28
J,2,57241,116,e,100,-16
J,2,57341,68, ,243,175
J,2,57584,112,m,100,-12
J,2,57684,80,i,178,98
J,2,57862,112,x,378,266
J,2,58240,100,t,125,25
J,2,58365,68,u,80,12
J,2,58445,156,r,76,-80
J,2,58521,128,e,73,-55
J,2,58594,79, ,117,38
J,2,58711,147,i,107,-40
J,2,58818,104,n,96,-8
J,2,58914,40, ,1540,1500
J,2,60454,92,a,217,125
J,2,60671,60, ,2835,2775
J,2,63506,108,p,209,101
J,2,63715,60,i,151,91
J,2,63866,176,e,238,62
J,2,64104,64, ,109,45
J,2,64213,104,t,108,4
J,2,64321,84,i,281,197
J,2,64602,84,n,121,37
J,2,64723,80, ,134,54
J,2,64857,100,w,68,-32
J,2,64925,80,i,130,50
J,2,65055,72,t,49,-23
J,2,65104,103,h,76,-27
J,2,65180,88, ,243,155
J,2,65423,115,h,83,-32
J,2,65506,128,o,167,39
J,2,65673,92,m,175,83
J,2,65848,48,e,642,594
J,2,66490,100,m,154,54
J,2,66644,110,a,129,19
J,2,66773,208,d,128,-80
J,2,66901,144,e,116,-28
J,2,67017,88, ,106,18
J,2,67123,201,c,100,-101
J,2,67223,117,r,148,31
J,2,67371,68,u,91,23
J,2,67462,100,s,60,-40
J,2,67522,88,t,112,24
J,2,67634,96,.,92,-4
J,2,67726,68, ,175,107
J,2,67901,60,i,805,745
J,2,68706,75,I,120,45
J,2,68826,84,t,88,4
J,2,68914,76, ,204,128
J,2,69118,75,i,111,36
J,2,69229,100,s,100,0
J,2,69329,88, ,162,74
J,2,69491,220,t,116,-104
J,2,69607,85,h,48,-37
J,2,69655,133,e,93,-40
J,2,69748,67, ,1398,1331
J,2,71146,180,d,96,-84
J,2,71242,111,e,204,93
J,2,71446,88,l,125,37
J,2,71571,84,i,123,39
J,2,71694,76,c,101,25
J,2,71795,117,i,88,-29
J,2,71883,148,o,128,-20
J,2,72011,80,u,99,19
J,2,72110,53,s,NA,NA
K,1,13,68,F,246,178
K,1,259,80,a,82,2
K,1,341,85,r,89,4
K,1,430,88, ,743,655
K,1,1173,71,o,180,109
K,1,1353,60,u,109,49
K,1,1462,76,t,61,-15
K,1,1523,95, ,172,77
K,1,1695,68,i,204,136
K,1,1899,108,n,112,4
K,1,2011,92, ,153,61
K,1,2164,76,t,83,7
K,1,2247,76,h,377,301
K,1,2624,60,e,75,15
K,1,2699,104, ,845,741
K,1,3544,60,u,209,149
K,1,3753,44,n,265,221
K,1,4018,36,c,71,35
K,1,4089,59,h,196,137
K,1,4285,61,a,100,39
K,1,4385,44,r,170,126
K,1,4555,61,t,99,38
K,1,4654,60,e,235,175
K,1,4889,40,d,104,64
K,1,4993,86, ,762,676
K,1,5755,41,b,102,61
K,1,5857,75,a,261,186
K,1,6118,44,c,104,60
K,1,6222,61,k,184,123
K,1,6406,85,w,1430,1345
K,1,7836,68,a,727,659
K,1,8563,52,t,94,42
K,1,8657,56,e,111,55
K,1,8768,73,r,311,238
K,1,9079,48,s,94,46
K,1,9173,84, ,788,704
K,1,9961,57,o,219,162
K,1,10180,67,f,64,-3
K,1,10244,92, ,167,75
K,1,10411,52,t,68,16
K,1,10479,68,h,199,131
K,1,10678,77,e,85,8
K,1,10763,100, ,869,769
K,1,11632,57,u,213,156
K,1,11845,60,n,247,187
K,1,12092,48,f,117,69
K,1,12209,77,a,318,241
K,1,12527,50,s,1370,1320
K,1,13897,48,h,501,453
K,1,14398,60,i,138,78
K,1,14536,61,o,164,103
K,1,14700,65,n,127,62
K,1,14827,81,a,827,746
K,1,15654,39,b,292,253
K,1,15946,57,l,167,110
K,1,16113,57,e,108,51
K,1,16221,93, ,220,127
K,1,16441,69,e,111,42
K,1,16552,61,n,152,91
K,1,16704,52,d,156,104
K,1,16860,93, ,276,183
K,1,17136,37,o,212,175
K,1,17348,93,f,139,46
K,1,17487,85, ,113,28
K,1,17600,61,t,125,64
K,1,17725,49,h,152,103
K,1,17877,68,e,102,34
K,1,17979,97, ,336,239
K,1,18315,68,w,204,136
K,1,18519,56,e,182,126
K,1,18701,60,s,72,12
K,1,18773,68,t,153,85
K,1,18926,69,e,234,165
K,1,19160,53,r,157,104
K,1,19317,89,n,149,60
K,1,19466,109, ,289,180
K,1,19755,48,s,131,83
K,1,19886,76,p,183,107
K,1,20069,62,i,117,55
K,1,20186,58,r,266,208
K,1,20452,71,a,55,-16
K,1,20507,96,l,172,76
K,1,20679,92, ,133,41
K,1,20812,89,a,232,143
K,1,21044,57,r,119,62
K,1,21163,72,m,434,362
K,1,21597,96, ,358,262
K,1,21955,45,o,173,128
K,1,22128,81,f,98,17
K,1,22226,82, ,140,58
K,1,22366,53,t,107,54
K,1,22473,57,h,136,79
K,1,22609,73,e,87,14
K,1,22696,77, ,585,508
K,1,23281,57,G,289,232
K,1,23570,64,a,102,38
K,1,23672,65,l,90,25
K,1,23762,52,a,230,178
K,1,23992,45,x,181,136
K,1,24173,75,y,80,5
K,1,24253,91, ,1640,1549
K,1,25893,52,l,238,186
K,1,26131,65,i,182,117
K,1,26313,97,e,348,251
K,1,26661,52,s,140,88
K,1,26801,85, ,173,88
K,1,26974,65,a,98,33
K,1,27072,81, ,201,120
K,1,27273,61,s,167,106
K,1,27440,61,m,160,99
K,1,27600,85,a,132,47
K,1,27732,65,l,176,111
K,1,27908,61,l,178,117
K,1,28086,89, ,567,478
K,1,28653,76,u,314,238
K,1,28967,69,n,918,849
K,1,29885,51,r,200,149
K,1,30085,73,e,134,61
K,1,30219,81,g,1978,1897
K,1,32197,68,a,152,84
K,1,32349,44,r,87,43
K,1,32436,64,d,213,149
K,1,32649,61,e,534,473
K,1,33183,69,d,76,7
K,1,33259,96, ,5489,5393
K,1,38748,42,y,164,122
K,1,38912,60,e,233,173
K,1,39145,52,l,134,82
K,1,39279,52,l,153,101
K,1,39432,56,o,64,8
K,1,39496,56,w,110,54
K,1,39606,105, ,161,56
K,1,39767,81,s,817,736
K,1,40584,61,u,375,314
K,1,40959,44,n,17820,17776
K,1,58779,108,.,13099,12991
K,1,71878,67,O,359,292
K,1,72237,64,r,131,67
K,1,72368,66,b,237,171
K,1,72605,73,i,196,123
K,1,72801,53,t,268,215
K,1,73069,73,i,763,690
K,1,73832,44,n,112,68
K,1,73944,77,g,131,54
K,1,74075,105, ,145,40
K,1,74220,69,t,406,337
K,1,74626,64,h,203,139
K,1,74829,65,i,89,24
K,1,74918,64,s,588,524
K,1,75506,76, ,205,129
K,1,75711,70,a,85,15
K,1,75796,72,t,155,83
K,1,75951,88, ,217,129
K,1,76168,73,a,129,56
K,1,76297,97, ,226,129
K,1,76523,69,d,98,29
K,1,76621,68,i,318,250
K,1,76939,68,s,230,162
K,1,77169,44,t,113,69
K,1,77282,73,a,145,72
K,1,77427,61,n,1003,942
K,1,78430,76,c,199,123
K,1,78629,69,e,87,18
K,1,78716,92, ,226,134
K,1,78942,53,o,653,600
K,1,79595,68,f,102,34
K,1,79697,101, ,166,65
K,1,79863,57,r,85,28
K,1,79948,84,o,148,64
K,1,80096,73,u,205,132
K,1,80301,61,g,196,135
K,1,80497,65,h,196,131
K,1,80693,85,l,141,56
K,1,80834,61,y,90,29
K,1,80924,104, ,1263,1159
K,1,82187,53,n,493,440
K,1,82680,65,i,267,202
K,1,82947,57,n,1789,1732
K,1,84736,81,e,1377,1296
K,1,86113,56,t,36,-20
K,1,86149,88,y,536,448
K,1,86685,65,t,339,274
K,1,87024,69,w,117,48
K,1,87141,69,o,471,402
K,1,87612,69, ,309,240
K,1,87921,77,m,212,135
K,1,88133,52,i,185,133
K,1,88318,44,l,116,72
K,1,88434,53,l,173,120
K,1,88607,64,i,122,58
K,1,88729,81,o,204,123
K,1,88933,64,n,326,262
K,1,89259,88, ,701,613
K,1,89960,68,m,193,125
K,1,90153,65,i,217,152
K,1,90370,57,l,87,30
K,1,90457,56,e,256,200
K,1,90713,65,s,103,38
K,1,90816,88, ,194,106
K,1,91010,69,i,259,190
K,1,91269,56,s,95,39
K,1,91364,100, ,156,56
K,1,91520,77,a,148,71
K,1,91668,65,n,164,99
K,1,91832,92, ,576,484
K,1,92408,52,u,173,121
K,1,92581,49,t,152,103
K,1,92733,53,t,243,190
K,1,92976,77,e,245,168
K,1,93221,69,r,625,556
K,1,93846,60,l,262,202
K,1,94108,80,y,88,8
K,1,94196,76, ,192,116
K,1,94388,60,i,203,143
K,1,94591,52,n,114,62
K,1,94705,44,s,176,132
K,1,94881,56,i,161,105
K,1,95042,38,f,489,451
K,1,95531,55,g,3171,3116
K,1,98702,44,n,1386,1342
K,1,100088,60,i,273,213
K,1,100361,76,f,130,54
K,1,100491,64,i,79,15
K,1,100570,68,c,208,140
K,1,100778,80,a,82,2
K,1,100860,62,n,240,178
K,1,101100,48,t,329,281
K,1,101429,76, ,263,187
K,1,101692,71,l,194,123
K,1,101886,52,i,133,81
K,1,102019,57,t,157,100
K,1,102176,75,t,111,36
K,1,102287,48,l,184,136
K,1,102471,56,e,102,46
K,1,102573,104, ,304,200
K,1,102877,48,v,622,574
K,1,103499,68,b,117,49
K,1,103616,69,l,230,161
K,1,103846,68,u,117,49
K,1,103963,64,e,108,44
K,1,104071,80, ,1701,1621
K,1,105772,64,g,203,139
K,1,105975,44,r,100,56
K,1,106075,56,e,176,120
K,1,106251,56,e,75,19
K,1,106326,88,n,104,16
K,1,106430,81, ,265,184
K,1,106695,72,p,203,131
K,1,106898,48,l,125,77
K,1,107023,73,a,171,98
K,1,107194,60,n,138,78
K,1,107332,60,e,1013,953
K,1,108345,89,t,464,375
K,1,108809,76, ,608,532
K,1,109417,71,w,150,79
K,1,109567,56,h,194,138
K,1,109761,52,o,714,662
K,1,110475,57,e,96,39
K,1,110571,101, ,814,713
K,1,111385,72,a,84,12
K,1,111469,32,o,164,132
K,1,111633,60,e,916,856
K,1,112549,64,p,76,12
K,1,112625,68,e,951,883
K,1,113576,48,d,222,174
K,1,113798,56,e,272,216
K,1,114070,64,s,498,434
K,1,114568,84,c,266,182
K,1,114834,64,e,207,143
K,1,115041,48,n,203,155
K,1,115244,92,d,190,98
K,1,115434,60,e,1877,1817
K,1,117311,81,d,88,7
K,1,117399,83, ,661,578
K,1,118060,61,l,192,131
K,1,118252,48,i,118,70
K,1,118370,68,f,190,122
K,1,118560,80,e,76,-4
K,1,118636,72, ,120,48
K,1,118756,81,f,141,60
K,1,118897,64,o,116,52
K,1,119013,60,r,139,79
K,1,119152,56,m,448,392
K,1,119600,84, ,342,258
K,1,119942,84,a,166,82
K,1,120108,64,r,109,45
K,1,120217,60,e,118,58
K,1,120335,72, ,145,73
K,1,120480,64,s,102,38
K,1,120582,80,o,274,194
K,1,120856,92, ,297,205
K,1,121153,72,a,97,25
K,1,121250,52,m,171,119
K,1,121421,81,a,379,298
K,1,121800,48,z,117,69
K,1,121917,60,i,199,139
K,1,122116,48,n,122,74
K,1,122238,56,g,142,86
K,1,122380,57,l,175,118
K,1,122555,52,y,1442,1390
K,1,123997,64, ,337,273
K,1,124334,72,p,109,37
K,1,124443,65,r,121,56
K,1,124564,64,i,212,148
K,1,124776,53,m,177,124
K,1,124953,64,i,147,83
K,1,125100,56,t,85,29
K,1,125185,81,i,226,145
K,1,125411,60,v,134,74
K,1,125545,60,e,226,166
K,1,125771,93, ,471,378
K,1,126242,44,t,185,141
K,1,126427,56,h,115,59
K,1,126542,65,a,143,78
K,1,126685,68,t,427,359
K,1,127112,88, ,389,301
K,1,127501,68,t,195,127
K,1,127696,64,h,90,26
K,1,127786,45,e,83,38
K,1,127869,97,y,108,11
K,1,127977,81, ,666,585
K,1,128643,65,s,304,239
K,1,128947,48,t,107,59
K,1,129054,69,i,259,190
K,1,129313,24,l,117,93
K,1,129430,44,l,250,206
K,1,129680,76, ,126,50
K,1,129806,49,t,130,81
K,1,129936,64,h,195,131
K,1,130131,56,i,189,133
K,1,130320,64,n,160,96
K,1,130480,101,k,105,4
K,1,130585,96, ,917,821
K,1,131502,69,d,103,34
K,1,131605,77,i,253,176
K,1,131858,65,g,199,134
K,1,132057,57,i,95,38
K,1,132152,65,t,297,232
K,1,132449,80,a,52,-28
K,1,132501,83,l,152,69
K,1,132653,93, ,770,677
K,1,133423,65,w,211,146
K,1,133634,100,a,104,4
K,1,133738,64,t,180,116
K,1,133918,49,c,102,53
K,1,134020,69,h,169,100
K,1,134189,62,w,558,496
K,1,134747,72,e,191,119
K,1,134938,71,s,23,-48
K,1,134961,88, ,1043,955
K,1,136004,88,a,136,48
K,1,136140,61,r,107,46
K,1,136247,65,e,113,48
K,1,136360,77, ,170,93
K,1,136530,84,a,99,15
K,1,136629,75, ,1869,1794
K,1,138498,44,p,111,67
K,1,138609,60,r,188,128
K,1,138797,73,e,133,60
K,1,138930,36,t,133,97
K,1,139063,65,t,1146,1081
K,1,140209,72,y,87,15
K,1,140296,84, ,228,144
K,1,140524,60,n,142,82
K,1,140666,81,e,985,904
K,1,141651,67,a,89,22
K,1,141740,80,t,113,33
K,1,141853,97, ,239,142
K,1,142092,61,i,103,42
K,1,142195,77,d,175,98
K,1,142370,85,e,313,228
K,1,142683,68,a,240,172
K,1,142923,37,s,1322,1285
K,1,144245,36,.,1182,1146
K,1,145427,62,T,210,148
K,1,145637,65,h,182,117
K,1,145819,48,i,74,26
K,1,145893,60,s,95,35
K,1,145988,108, ,2911,2803
K,1,148899,52,p,205,153
K,1,149104,49,l,67,18
K,1,149171,68,a,225,157
K,1,149396,69,n,143,74
K,1,149539,65,e,132,67
K,1,149671,92,t,116,24
K,1,149787,104, ,469,365
K,1,150256,52,h,112,60
K,1,150368,73,a,727,654
K,1,151095,68,s,390,322
K,1,151485,69,",",137,68
K,1,151622,77, ,163,86
K,1,151785,61,o,157,96
K,1,151942,45,r,75,30
K,1,152017,80, ,332,252
K,1,152349,76,r,258,182
K,1,152607,100,a,73,-27
K,1,152680,55,t,185,130
K,1,152865,63,h,71,8
K,1,152936,72,e,409,337
K,1,153345,61,r,127,66
K,1,153472,69, ,1166,1097
K,1,154638,76,h,109,33
K,1,154747,69,a,405,336
K,1,155152,61,d,110,49
K,1,155262,69,",",258,189
K,1,155520,89, ,334,245
K,1,155854,96,a,100,4
K,1,155954,92, ,230,138
K,1,156184,69,p,129,60
K,1,156313,45,r,63,18
K,1,156376,72,o,263,191
K,1,156639,41,b,214,173
K,1,156853,73,l,127,54
K,1,156980,80,e,128,48
K,1,157108,53,m,926,873
K,1,158034,76,",",168,92
K,1,158202,88, ,144,56
K,1,158346,57,w,136,79
K,1,158482,65,h,153,88
K,1,158635,81,i,104,23
K,1,158739,61,c,101,40
K,1,158840,68,h,281,213
K,1,159121,81, ,780,699
K,1,159901,37,w,201,164
K,1,160102,81,a,351,270
K,1,160453,48,s,50,2
K,1,160503,78, ,171,93
K,1,160674,56,t,68,12
K,1,160742,68,h,161,93
K,1,160903,53,i,125,72
K,1,161028,73,s,466,393
K,1,161494,72,:,293,221
K,1,161787,77, ,1597,1520
K,1,163384,60,m,188,128
K,1,163572,52,o,36,-16
K,1,163608,64,s,282,218
K,1,163890,41,t,71,30
K,1,163961,80, ,188,108
K,1,164149,57,o,94,37
K,1,164243,96,f,119,23
K,1,164362,89, ,119,30
K,1,164481,53,t,342,289
K,1,164823,53,h,99,46
K,1,164922,52,e,102,50
K,1,165024,80, ,450,370
K,1,165474,65,p,95,30
K,1,165569,64,e,78,14
K,1,165647,57,o,169,112
K,1,165816,57,p,186,129
K,1,166002,53,l,80,27
K,1,166082,56,e,81,25
K,1,166163,96, ,360,264
K,1,166523,73,o,216,143
K,1,166739,80,n,88,8
K,1,166827,80, ,153,73
K,1,166980,60,i,129,69
K,1,167109,48,t,136,88
K,1,167245,81, ,711,630
K,1,167956,80,w,226,146
K,1,168182,69,e,226,157
K,1,168408,57,r,210,153
K,1,168618,48,e,32,-16
K,1,168650,116, ,469,353
K,1,169119,43,i,1651,1608
K,1,170770,60,u,191,131
K,1,170961,60,n,159,99
K,1,171120,52,h,84,32
K,1,171204,60,a,158,98
K,1,171362,57,p,132,75
K,1,171494,65,p,208,143
K,1,171702,87,y,80,-7
K,1,171782,88, ,1044,956
K,1,172826,71,f,96,25
K,1,172922,65,o,105,40
K,1,173027,65,r,91,26
K,1,173118,104, ,922,818
K,1,174040,49,p,129,80
K,1,174169,61,r,193,132
K,1,174362,73,e,113,40
K,1,174475,44,t,129,85
K,1,174604,56,t,161,105
K,1,174765,72,y,112,40
K,1,174877,92, ,196,104
K,1,175073,60,m,255,195
K,1,175328,77,c,899,822
K,1,176227,80,u,185,105
K,1,176412,61,c,124,63
K,1,176536,60,h,77,17
K,1,176613,105, ,3624,3519
K,1,180237,64,o,102,38
K,1,180339,89,f,114,25
K,1,180453,89, ,140,51
K,1,180593,53,t,82,29
K,1,180675,60,h,141,81
K,1,180816,71,e,56,-15
K,1,180872,88, ,188,100
K,1,181060,64,t,79,15
K,1,181139,68,i,202,134
K,1,181341,88,m,106,18
K,1,181447,61,e,498,437
K,1,181945,63,.,162,99
K,1,182107,68, ,245,177
K,1,182352,44,m,271,227
K,1,182623,52,A,132,80
K,1,182755,44,N,198,154
K,1,182953,76,Y,72,-4
K,1,183025,80, ,186,106
K,1,183211,73,S,92,19
K,1,183303,52,O,186,134
K,1,183489,61,L,210,149
K,1,183699,60,U,129,69
K,1,183828,44,T,82,38
K,1,183910,80,I,169,89
K,1,184079,56,O,184,128
K,1,184263,57,N,128,71
K,1,184391,52,S,278,226
K,1,184669,80, ,230,150
K,1,184899,72,W,227,155
K,1,185126,56,E,125,69
K,1,185251,64,R,103,39
K,1,185354,56,E,120,64
K,1,185474,65, ,130,65
K,1,185604,48,S,90,42
K,1,185694,72,U,3133,3061
K,1,188827,24,M,270,246
K,1,189097,52,a,81,29
K,1,189178,48,n,188,140
K,1,189366,76,y,72,-4
K,1,189438,88, ,611,523
K,1,190049,61,s,235,174
K,1,190284,56,o,196,140
K,1,190480,52,l,188,136
K,1,190668,56,u,133,77
K,1,190801,64,t,112,48
K,1,190913,88,i,142,54
K,1,191055,60,o,191,131
K,1,191246,68,n,171,103
K,1,191417,52,s,82,30
K,1,191499,72, ,126,54
K,1,191625,53,w,223,170
K,1,191848,56,e,105,49
K,1,191953,68,r,148,80
K,1,192101,28,e,70,42
K,1,192171,80, ,175,95
K,1,192346,52,s,103,51
K,1,192449,68,u,196,128
K,1,192645,56,g,141,85
K,1,192786,72,g,120,48
K,1,192906,29,e,164,135
K,1,193070,64,s,84,20
K,1,193154,44,t,146,102
K,1,193300,52,e,208,156
K,1,193508,52,d,54,2
K,1,193562,94, ,1592,1498
K,1,195154,71,f,117,46
K,1,195271,61,o,69,8
K,1,195340,76,r,164,88
K,1,195504,92, ,249,157
K,1,195753,52,t,960,908
K,1,196713,68,h,171,103
K,1,196884,56,i,73,17
K,1,196957,67,s,107,40
K,1,197064,69, ,177,108
K,1,197241,68,p,119,51
K,1,197360,55,r,32,-23
K,1,197392,80,o,267,187
K,1,197659,36,b,216,180
K,1,197875,60,l,123,63
K,1,197998,73,e,328,255
K,1,198326,72,m,904,832
K,1,199230,76,",",162,86
K,1,199392,93, ,989,896
K,1,200381,72,b,182,110
K,1,200563,60,u,100,40
K,1,200663,44,t,80,36
K,1,200743,79, ,215,136
K,1,200958,32,m,130,98
K,1,201088,68,o,83,15
K,1,201171,71,s,305,234
K,1,201476,60,t,101,41
K,1,201577,120, ,551,431
K,1,202128,61,o,75,14
K,1,202203,73,f,107,34
K,1,202310,73, ,92,19
K,1,202402,68,t,131,63
K,1,202533,60,h,204,144
K,1,202737,68,e,250,182
K,1,202987,48,s,251,203
K,1,203238,40,e,84,44
K,1,203322,79, ,577,498
K,1,203899,64,w,206,142
K,1,204105,64,e,165,101
K,1,204270,45,r,88,43
K,1,204358,56,e,113,57
K,1,204471,77, ,245,168
K,1,204716,36,l,61,25
K,1,204777,89,a,227,138
K,1,205004,56,r,186,130
K,1,205190,52,g,124,72
K,1,205314,68,e,137,69
K,1,205451,72,l,201,129
K,1,205652,83,y,64,-19
K,1,205716,104, ,1534,1430
K,1,207250,60,c,134,74
K,1,207384,72,o,213,141
K,1,207597,48,n,71,23
K,1,207668,76,c,181,105
K,1,207849,80,e,217,137
K,1,208066,60,r,120,60
K,1,208186,45,n,62,17
K,1,208248,81,e,317,236
K,1,208565,60,d,90,30
K,1,208655,96, ,364,268
K,1,209019,72,w,111,39
K,1,209130,72,i,178,106
K,1,209308,61,t,65,4
K,1,209373,92,h,370,278
K,1,209743,96, ,187,91
K,1,209930,84,t,222,138
K,1,210152,76,h,142,66
K,1,210294,69,e,91,22
K,1,210385,81, ,260,179
K,1,210645,65,m,171,106
K,1,210816,61,o,210,149
K,1,211026,44,v,116,72
K,1,211142,53,e,214,161
K,1,211356,60,m,120,60
K,1,211476,73,e,314,241
K,1,211790,64,t,114,50
K,1,211904,80, ,1722,1642
K,1,213626,79,t,1343,1264
K,1,214969,112,n,166,54
K,1,215135,68,t,72,4
K,1,215207,91, ,1969,1878
K,1,217176,83,s,167,84
K,1,217343,74, ,1295,1221
K,1,218638,68,o,127,59
K,1,218765,69,f,94,25
K,1,218859,89, ,214,125
K,1,219073,69,s,93,24
K,1,219166,73,m,155,82
K,1,219321,85,a,93,8
K,1,219414,47,l,146,99
K,1,219560,64,l,135,71
K,1,219695,93, ,542,449
K,1,220237,52,g,121,69
K,1,220358,69,r,208,139
K,1,220566,68,e,179,111
K,1,220745,56,e,36,-20
K,1,220781,95,n,156,61
K,1,220937,89, ,645,556
K,1,221582,72,p,184,112
K,1,221766,48,i,96,48
K,1,221862,60,e,225,165
K,1,222087,89,c,301,212
K,1,222388,72,e,400,328
K,1,222788,52,s,164,112
K,1,222952,89, ,194,105
K,1,223146,40,o,104,64
K,1,223250,82,f,293,211
K,1,223543,88, ,422,334
K,1,223965,60,p,98,38
K,1,224063,73,a,97,24
K,1,224160,60,p,133,73
K,1,224293,64,e,291,227
K,1,224584,52,r,441,389
K,1,225025,65,",",160,95
K,1,225185,97, ,114,17
K,1,225299,69,w,145,76
K,1,225444,65,h,162,97
K,1,225606,69,i,132,63
K,1,225738,27,c,58,31
K,1,225796,84,h,107,23
K,1,225903,85, ,225,140
K,1,226128,61,i,91,30
K,1,226219,60,s,83,23
K,1,226302,92, ,632,540
K,1,226934,53,o,123,70
K,1,227057,73,d,213,140
K,1,227270,53,d,81,28
K,1,227351,80, ,729,649
K,1,228080,52,b,53,1
K,1,228133,71,e,170,99
K,1,228303,61,c,136,75
K,1,228439,77,a,144,67
K,1,228583,70,u,69,-1
K,1,228652,51,s,215,164
K,1,228867,60,e,107,47
K,1,228974,77, ,485,408
K,1,229459,47,o,195,148
K,1,229654,81,n,114,33
K,1,229768,61, ,91,30
K,1,229859,64,t,160,96
K,1,230019,16,h,84,68
K,1,230103,65,e,117,52
K,1,230220,101, ,175,74
K,1,230395,73,w,123,50
K,1,230518,61,h,201,140
K,1,230719,61,o,215,154
K,1,230934,72,l,65,-7
K,1,230999,71,e,83,12
K,1,231082,84, ,1576,1492
K,1,232658,54,i,137,83
K,1,232795,53,t,125,72
K,1,232920,89, ,221,132
K,1,233141,57,w,230,173
K,1,233371,65,a,158,93
K,1,233529,96,s,92,-4
K,1,233621,41,n,339,298
K,1,233960,40,',244,204
K,1,234204,65,t,86,21
K,1,234290,89, ,1768,1679
K,1,236058,53,t,69,16
K,1,236127,52,h,162,110
K,1,236289,76,e,77,1
K,1,236366,87, ,196,109
K,1,236562,57,s,1853,1796
K,1,238415,52,s,127,75
K,1,238542,69,m,111,42
K,1,238653,57,a,132,75
K,1,238785,41,l,124,83
K,1,238909,57,l,161,104
K,1,239070,85, ,770,685
K,1,239840,53,g,183,130
K,1,240023,53,r,84,31
K,1,240107,64,e,191,127
K,1,240298,57,e,124,67
K,1,240422,77,n,195,118
K,1,240617,149, ,544,395
K,1,241161,72,p,158,86
K,1,241319,45,e,69,24
K,1,241388,44,i,620,576
K,1,242008,57,i,118,61
K,1,242126,77,e,267,190
K,1,242393,73,c,204,131
K,1,242597,61,e,237,176
K,1,242834,65,s,116,51
K,1,242950,85, ,199,114
K,1,243149,41,o,86,45
K,1,243235,88,f,197,109
K,1,243432,81, ,129,48
K,1,243561,65,t,1290,1225
K,1,244851,41,h,78,37
K,1,244929,56,e,84,28
K,1,245013,89, ,619,530
K,1,245632,52,p,110,58
K,1,245742,69,a,126,57
K,1,245868,49,p,149,100
K,1,246017,65,e,697,632
K,1,246714,56,r,40,-16
K,1,246754,97, ,802,705
K,1,247556,65,t,234,169
K,1,247790,65,h,101,36
K,1,247891,65,a,122,57
K,1,248013,92,t,84,-8
K,1,248097,92, ,341,249
K,1,248438,77,w,236,159
K,1,248674,69,e,106,37
K,1,248780,84,r,119,35
K,1,248899,64,e,143,79
K,1,249042,53, ,981,928
K,1,250023,60,u,193,133
K,1,250216,73,n,173,100
K,1,250389,53,h,85,32
K,1,250474,60,a,203,143
K,1,250677,45,p,136,91
K,1,250813,57,p,205,148
K,1,251018,84,y,60,-24
K,1,251078,84, ,1728,1644
K,1,252806,89,.,3804,3715
K,1,256610,97, ,NA,NA
K,2,93,64,M,356,292
K,2,449,48,t,650,602
K,2,1099,76,y,72,-4
K,2,1171,80, ,242,162
K,2,1413,56,f,116,60
K,2,1529,41,a,142,101
K,2,1671,57,v,223,166
K,2,1894,64,o,116,52
K,2,2010,52,r,88,36
K,2,2098,76,i,246,170
K,2,2344,56,t,91,35
K,2,2435,52,e,86,34
K,2,2521,81, ,1394,1313
K,2,3915,53,f,148,95
K,2,4063,27,o,138,111
K,2,4201,56,o,78,22
K,2,4279,60,d,71,11
K,2,4350,85, ,233,148
K,2,4583,51,s,40,-11
K,2,4623,112, ,663,551
K,2,5286,61,i,81,20
K,2,5367,71,s,47,-24
K,2,5414,96, ,2382,2286
K,2,7796,60,m,249,189
K,2,8045,72,y,80,8
K,2,8125,95, ,260,165
K,2,8385,52,m,156,104
K,2,8541,60,o,197,137
K,2,8738,52,m,429,377
K,2,9167,40,',95,55
K,2,9262,48,s,129,81
K,2,9391,76, ,576,500
K,2,9967,64,c,90,26
K,2,10057,61,h,145,84
K,2,10202,68,i,76,8
K,2,10278,80,c,211,131
K,2,10489,56,k,119,63
K,2,10608,64,e,912,848
K,2,11520,24,e,68,44
K,2,11588,53,n,124,71
K,2,11712,100, ,278,178
K,2,11990,48,n,174,126
K,2,12164,56,o,139,83
K,2,12303,56,o,109,53
K,2,12412,56,d,122,66
K,2,12534,64,l,113,49
K,2,12647,72,e,74,2
K,2,12721,98, ,218,120
K,2,12939,28,s,113,85
K,2,13052,64,o,192,128
K,2,13244,28,u,245,217
K,2,13489,56,p,513,457
K,2,14002,36,.,172,136
K,2,14174,68, ,5728,5660
K,2,19902,53,W,416,363
K,2,20318,44,h,1197,1153
K,2,21515,52,i,203,151
K,2,21718,60,l,85,25
K,2,21803,49,e,101,52
K,2,21904,93, ,347,254
K,2,22251,52,i,85,33
K,2,22336,57,t,118,61
K,2,22454,85, ,170,85
K,2,22624,52,s,1697,1645
K,2,24321,56,i,80,24
K,2,24401,47,s,59,12
K,2,24460,73, ,156,83
K,2,24616,53,n,163,110
K,2,24779,64,o,76,12
K,2,24855,39,t,489,450
K,2,25344,71,h,166,95
K,2,25510,76,i,219,143
K,2,25729,64,n,76,12
K,2,25805,64,g,91,27
K,2,25896,97, ,338,241
K,2,26234,56,f,132,76
K,2,26366,73,a,98,25
K,2,26464,80,n,136,56
K,2,26600,76,c,133,57
K,2,26733,81,y,85,4
K,2,26818,112, ,2552,2440
K,2,29370,20,",",1055,1035
K,2,30425,84, ,273,189
K,2,30698,60,I,166,106
K,2,30864,80, ,148,68
K,2,31012,40,a,2291,2251
K,2,33303,76,w,88,12
K,2,33391,69,o,136,67
K,2,33527,65,u,196,131
K,2,33723,85,l,81,-4
K,2,33804,63,d,63,0
K,2,33867,84, ,157,73
K,2,34024,65,b,83,18
K,2,34107,64,e,100,36
K,2,34207,88, ,119,31
K,2,34326,92,a,85,-7
K,2,34411,43,b,194,151
K,2,34605,56,l,52,-4
K,2,34657,76,e,90,14
K,2,34747,97, ,129,32
K,2,34876,73,t,101,28
K,2,34977,80,o,28,-52
K,2,35005,149, ,473,324
K,2,35478,72,e,232,160
K,2,35710,57,a,87,30
K,2,35797,85,t,107,22
K,2,35904,101, ,361,260
K,2,36265,27,i,171,144
K,2,36436,56,t,90,34
K,2,36526,96, ,225,129
K,2,36751,65,a,88,23
K,2,36839,56,n,203,147
K,2,37042,68,y,103,35
K,2,37145,69,t,153,84
K,2,37298,65,o,563,498
K,2,37861,45,i,194,149
K,2,38055,47,m,59,12
K,2,38114,64,e,698,634
K,2,38812,40,.,253,213
K,2,39065,64, ,4539,4475
K,2,43604,64,S,275,211
K,2,43879,57,h,144,87
K,2,44023,57,e,81,24
K,2,44104,89, ,136,47
K,2,44240,77,s,96,19
K,2,44336,28,o,353,325
K,2,44689,44,m,77,33
K,2,44766,64,e,220,156
K,2,44986,57,t,201,144
K,2,45187,57,i,213,156
K,2,45400,56,m,52,-4
K,2,45452,64,e,221,157
K,2,45673,53,s,70,17
K,2,45743,96, ,1292,1196
K,2,47035,48,b,222,174
K,2,47257,72,o,134,62
K,2,47391,57,i,195,138
K,2,47586,69,l,101,32
K,2,47687,45,s,93,48
K,2,47780,108, ,350,242
K,2,48130,53,b,191,138
K,2,48321,65,o,141,76
K,2,48462,41,t,68,27
K,2,48530,73,h,163,90
K,2,48693,117, ,175,58
K,2,48868,53,t,103,50
K,2,48971,57,u,336,279
K,2,49307,45,k,135,90
K,2,49442,77,e,144,67
K,2,49586,68,y,70,2
K,2,49656,78, ,152,74
K,2,49808,57,a,103,46
K,2,49911,49,n,115,66
K,2,50026,41,d,63,22
K,2,50089,100, ,237,137
K,2,50326,55,c,97,42
K,2,50423,57,h,161,104
K,2,50584,57,i,418,361
K,2,51002,80,c,256,176
K,2,51258,61,k,189,128
K,2,51447,57,e,87,30
K,2,51534,85,n,161,76
K,2,51695,73, ,230,157
K,2,51925,85,a,115,30
K,2,52040,52,n,86,34
K,2,52126,53,d,94,41
K,2,52220,85, ,353,268
K,2,52573,49,h,71,22
K,2,52644,69,a,3213,3144
K,2,55857,81,s,109,28
K,2,55966,65,u,165,100
K,2,56131,60,c,56,-4
K,2,56187,48,h,158,110
K,2,56345,53,i,2054,2001
K,2,58399,61,s,130,69
K,2,58529,20,h,295,275
K,2,58824,65,i,594,529
K,2,59418,69,.,175,106
K,2,59593,80, ,217,137
K,2,59810,56,I,181,125
K,2,59991,77, ,105,28
K,2,60096,68,w,108,40
K,2,60204,69,o,133,64
K,2,60337,65,u,264,199
K,2,60601,81,l,137,56
K,2,60738,57,d,77,20
K,2,60815,72, ,170,98
K,2,60985,45,b,83,38
K,2,61068,52,e,78,26
K,2,61146,92, ,156,64
K,2,61302,71,a,52,-19
K,2,61354,44,b,193,149
K,2,61547,57,l,2465,2408
K,2,64012,73,a,68,-5
K,2,64080,56,m,125,69
K,2,64205,89, ,130,41
K,2,64335,83,a,72,-11
K,2,64407,76, ,169,93
K,2,64576,61,s,212,151
K,2,64788,65,e,887,822
K,2,65675,65,a,162,97
K,2,65837,85, ,1343,1258
K,2,67180,45,e,531,486
K,2,67711,88,a,160,72
K,2,67871,80, ,892,812
K,2,68763,77,f,111,34
K,2,68874,52,o,148,96
K,2,69022,48,o,64,16
K,2,69086,68,d,92,24
K,2,69178,89, ,368,279
K,2,69546,52,l,157,105
K,2,69703,48,o,224,176
K,2,69927,37,v,55,18
K,2,69982,76,e,214,138
K,2,70196,48,r,52,4
K,2,70248,84, ,201,117
K,2,70449,81,a,106,25
K,2,70555,49,n,108,59
K,2,70663,52,d,76,24
K,2,70739,100, ,319,219
K,2,71058,56,I,190,134
K,2,71248,98, ,141,43
K,2,71389,60,w,89,29
K,2,71478,64,o,129,65
K,2,71607,64,u,200,136
K,2,71807,68,l,80,12
K,2,71887,68,d,86,18
K,2,71973,92, ,213,121
K,2,72186,32,b,92,60
K,2,72278,48,e,72,24
K,2,72350,100, ,153,53
K,2,72503,88,a,68,-20
K,2,72571,36,b,206,170
K,2,72777,64,l,80,16
K,2,72857,68,e,96,28
K,2,72953,96, ,331,235
K,2,73284,68,t,128,60
K,2,73412,73,o,113,40
K,2,73525,116, ,134,18
K,2,73659,76,e,230,154
K,2,73889,64,a,82,18
K,2,73971,72,t,87,15
K,2,74058,92, ,260,168
K,2,74318,65,s,135,70
K,2,74453,60,u,148,88
K,2,74601,40,c,106,66
K,2,74707,40,h,221,181
K,2,74928,40,i,52,12
K,2,74980,116, ,259,143
K,2,75239,81,e,181,100
K,2,75420,60,v,94,34
K,2,75514,64,e,211,147
K,2,75725,71,r,125,54
K,2,75850,40,y,184,144
K,2,76034,44,d,264,220
K,2,76298,107,a,40,-67
K,2,76338,44,y,816,772
K,2,77154,48,.,151,103
K,2,77305,88, ,5618,5530
K,2,82923,76,s,1656,1580
K,2,84579,61,I,240,179
K,2,84819,81,n,111,30
K,2,84930,96, ,331,235
K,2,85261,52,p,85,33
K,2,85346,64,a,250,186
K,2,85596,48,r,2968,2920
K,2,88564,47,p,59,12
K,2,88623,64,a,207,143
K,2,88830,64,r,193,129
K,2,89023,40,t,272,232
K,2,89295,56,c,58,2
K,2,89353,74,i,148,74
K,2,89501,48,u,188,140
K,2,89689,71,l,60,-11
K,2,89749,84,a,238,154
K,2,89987,48,r,44,-4
K,2,90031,96, ,598,502
K,2,90629,68,I,162,94
K,2,90791,84, ,160,76
K,2,90951,61,l,372,311
K,2,91323,60,i,192,132
K,2,91515,65,k,119,54
K,2,91634,52,e,55,3
K,2,91689,84, ,167,83
K,2,91856,57,s,187,130
K,2,92043,60,a,68,8
K,2,92111,56,l,191,135
K,2,92302,57,m,156,99
K,2,92458,60,o,191,131
K,2,92649,72,n,94,22
K,2,92743,107, ,653,546
K,2,93396,65,n,176,111
K,2,93572,61,i,224,163
K,2,93796,56,g,107,51
K,2,93903,60,i,183,123
K,2,94086,68,r,94,26
K,2,94180,56,i,778,722
K,2,94958,42,.,208,166
K,2,95166,72, ,375,303
K,2,95541,56,w,247,191
K,2,95788,51,h,174,123
K,2,95962,61,I,205,144
K,2,96167,56,L,52,-4
K,2,96219,56,E,96,40
K,2,96315,89, ,169,80
K,2,96484,73,M,100,27
K,2,96584,75,A,90,15
K,2,96674,61,N,168,107
K,2,96842,92,Y,96,4
K,2,96938,93, ,210,117
K,2,97148,72,P,107,35
K,2,97255,61,E,73,12
K,2,97328,68,O,181,113
K,2,97509,56,P,176,120
K,2,97685,61,L,94,33
K,2,97779,56,E,75,19
K,2,97854,93, ,2732,2639
K,2,100586,60,W,292,232
K,2,100878,53,h,192,139
K,2,101070,56,i,188,132
K,2,101258,64,l,85,21
K,2,101343,48,e,69,21
K,2,101412,76, ,166,90
K,2,101578,60,m,72,12
K,2,101650,68,a,101,33
K,2,101751,45,n,173,128
K,2,101924,75,y,64,-11
K,2,101988,83, ,208,125
K,2,102196,72,p,87,15
K,2,102283,65,e,105,40
K,2,102388,33,o,179,146
K,2,102567,69,p,262,193
K,2,102829,60,l,100,40
K,2,102929,37,e,55,18
K,2,102984,100, ,209,109
K,2,103193,65,c,214,149
K,2,103407,68,a,64,-4
K,2,103471,36,n,155,119
K,2,103626,36,n,1863,1827
K,2,105489,72,d,113,41
K,2,105602,60,o,182,122
K,2,105784,44,n,871,827
K,2,106655,48,',126,78
K,2,106781,36,t,103,67
K,2,106884,88, ,194,106
K,2,107078,60,e,169,109
K,2,107247,60,n,342,282
K,2,107589,44,j,149,105
K,2,107738,68,o,194,126
K,2,107932,72,y,83,11
K,2,108015,81, ,267,186
K,2,108282,68,r,294,226
K,2,108576,76,a,244,168
K,2,108820,64,w,104,40
K,2,108924,88, ,486,398
K,2,109410,80,f,127,47
K,2,109537,60,i,153,93
K,2,109690,52,s,67,15
K,2,109757,72,h,98,26
K,2,109855,65, ,1899,1834
K,2,111754,60,I,188,128
K,2,111942,97, ,6429,6332
K,2,118371,66,I,171,105
K,2,118542,76, ,142,66
K,2,118684,52,a,67,15
K,2,118751,60,m,56,-4
K,2,118807,109, ,338,229
K,2,119145,63,f,124,61
K,2,119269,65,u,232,167
K,2,119501,48,l,408,360
K,2,119909,64,l,404,340
K,2,120313,112,y,108,-4
K,2,120421,92, ,184,92
K,2,120605,84,a,205,121
K,2,120810,48,w,184,136
K,2,120994,76,a,91,15
K,2,121085,59,r,103,44
K,2,121188,60,e,85,25
K,2,121273,77, ,171,94
K,2,121444,60,t,187,127
K,2,121631,45,h,44,-1
K,2,121675,76,a,111,35
K,2,121786,69,t,61,-8
K,2,121847,72, ,212,140
K,2,122059,60,m,76,16
K,2,122135,69,a,99,30
K,2,122234,49,n,178,129
K,2,122412,72,y,80,8
K,2,122492,64, ,200,136
K,2,122692,72,p,87,15
K,2,122779,56,e,74,18
K,2,122853,57,o,166,109
K,2,123019,60,p,217,157
K,2,123236,49,l,83,34
K,2,123319,52,e,84,32
K,2,123403,77, ,1109,1032
K,2,124512,77,c,206,129
K,2,124718,80,a,76,-4
K,2,124794,40,n,134,94
K,2,124928,52,n,166,114
K,2,125094,57,o,64,7
K,2,125158,57,t,106,49
K,2,125264,89, ,156,67
K,2,125420,64,e,212,148
K,2,125632,64,a,65,1
K,2,125697,66,t,74,8
K,2,125771,81, ,1478,1397
K,2,127249,61,r,231,170
K,2,127480,88,a,558,470
K,2,128038,59,w,78,19
K,2,128116,84, ,744,660
K,2,128860,53,f,103,50
K,2,128963,61,i,152,91
K,2,129115,45,s,80,35
K,2,129195,52,h,746,694
K,2,129941,44,",",171,127
K,2,130112,81, ,166,85
K,2,130278,57,b,168,111
K,2,130446,56,u,68,12
K,2,130514,60,t,91,31
K,2,130605,76, ,180,104
K,2,130785,48,i,68,20
K,2,130853,64,t,98,34
K,2,130951,80, ,191,111
K,2,131142,57,d,93,36
K,2,131235,57,o,113,56
K,2,131348,61,e,219,158
K,2,131567,49,s,102,53
K,2,131669,52,n,386,334
K,2,132055,56,',143,87
K,2,132198,53,t,84,31
K,2,132282,88, ,217,129
K,2,132499,56,b,176,120
K,2,132675,69,o,76,7
K,2,132751,69,t,130,61
K,2,132881,57,h,115,58
K,2,132996,61,e,184,123
K,2,133180,52,r,45,-7
K,2,133225,80, ,152,72
K,2,133377,64,m,75,11
K,2,133452,57,e,450,393
K,2,133902,58,",",902,844
K,2,134804,31,.,251,220
K,2,135055,80, ,1003,923
K,2,136058,61,I,253,192
K,2,136311,76, ,200,124
K,2,136511,73,c,74,1
K,2,136585,66,o,118,52
K,2,136703,69,u,227,158
K,2,136930,60,l,65,5
K,2,136995,59,d,71,12
K,2,137066,80, ,187,107
K,2,137253,64,p,106,42
K,2,137359,53,r,75,22
K,2,137434,64,o,236,172
K,2,137670,49,b,95,46
K,2,137765,64,a,56,-8
K,2,137821,44,b,164,120
K,2,137985,65,l,183,118
K,2,138168,64,y,73,9
K,2,138241,92, ,160,68
K,2,138401,60,s,178,118
K,2,138579,76,a,56,-20
K,2,138635,76,y,89,13
K,2,138724,83, ,446,363
K,2,139170,53,I,166,113
K,2,139336,92, ,324,232
K,2,139660,57,h,71,14
K,2,139731,72,a,184,112
K,2,139915,60,d,65,5
K,2,139980,67, ,170,103
K,2,140150,69,t,187,118
K,2,140337,64,h,52,-12
K,2,140389,64,e,76,12
K,2,140465,60, ,147,87
K,2,140612,61,b,72,11
K,2,140684,56,e,187,131
K,2,140871,52,s,45,-7
K,2,140916,67,t,89,22
K,2,141005,60, ,146,86
K,2,141151,101,s,127,26
K,2,141278,65,u,168,103
K,2,141446,56,c,480,424
K,2,141926,44,h,741,697
K,2,142667,64,y,87,23
K,2,142754,84, ,842,758
K,2,143596,84,i,162,78
K,2,143758,76, ,803,727
K,2,144561,65,s,424,359
K,2,144985,41,h,150,109
K,2,145135,69,i,118,49
K,2,145253,89, ,153,64
K,2,145406,85,a,161,76
K,2,145567,86,t,142,56
K,2,145709,73, ,363,290
K,2,146072,65,L,265,200
K,2,146337,56,u,116,60
K,2,146453,77,c,99,22
K,2,146552,69,k,234,165
K,2,146786,64,y,69,5
K,2,146855,67, ,371,304
K,2,147226,65,A,821,756
K,2,148047,56,F,93,37
K,2,148140,60, ,265,205
K,2,148405,57,i,213,156
K,2,148618,89,n,116,27
K,2,148734,85, ,713,628
K,2,149447,56,R,326,270
K,2,149773,61,i,148,87
K,2,149921,52,c,64,12
K,2,149985,48,h,200,152
K,2,150185,57,m,141,84
K,2,150326,60,o,164,104
K,2,150490,52,n,48,-4
K,2,150538,52,d,455,403
K,2,150993,64,.,180,116
K,2,151173,89, ,323,234
K,2,151496,50,D,269,219
K,2,151765,65,e,44,-21
K,2,151809,64,f,208,144
K,2,152017,69,i,182,113
K,2,152199,61,n,149,88
K,2,152348,61,i,165,104
K,2,152513,61,t,93,32
K,2,152606,56,e,105,49
K,2,152711,92,l,187,95
K,2,152898,84,y,80,-4
K,2,152978,76, ,232,156
K,2,153210,61,r,180,119
K,2,153390,61,e,205,144
K,2,153595,69,c,110,41
K,2,153705,61,o,143,82
K,2,153848,68,o,197,129
K,2,154045,61,m,79,18
K,2,154124,68,e,994,926
K,2,155118,49,m,135,86
K,2,155253,57,m,85,28
K,2,155338,76,e,94,18
K,2,155432,61,n,305,244
K,2,155737,55,d,48,-7
K,2,155785,80, ,157,77
K,2,155942,65,i,90,25
K,2,156032,64,t,550,486
K,2,156582,68,.,NA,NA
L,1,150,141,F,181,40
L,1,331,132,a,150,18
L,1,481,97,r,108,11
L,1,589,111, ,130,19
L,1,719,144,o,89,-55
L,1,808,130,u,92,-38
L,1,900,94,t,62,-32
L,1,962,111, ,331,220
L,1,1293,154,i,84,-70
L,1,1377,116,n,91,-25
L,1,1468,108, ,114,6
L,1,1582,100,t,40,-60
L,1,1622,101,h,77,-24
L,1,1699,111,e,27,-84
L,1,1726,109, ,131,22
L,1,1857,91,u,180,89
L,1,2037,105,n,126,21
L,1,2163,120,c,130,10
L,1,2293,89,h,42,-47
L,1,2335,155,a,320,165
L,1,2655,68,t,354,286
L,1,3009,94,r,129,35
L,1,3138,118,t,168,50
L,1,3306,160,e,165,5
L,1,3471,183,d,184,1
L,1,3655,108, ,201,93
L,1,3856,102,B,487,385
L,1,4343,74,b,50,-24
L,1,4393,122,a,111,-11
L,1,4504,84,c,40,-44
L,1,4544,97,k,110,13
L,1,4654,83,w,84,1
L,1,4738,167,a,135,-32
L,1,4873,143,r,357,214
L,1,5230,90,t,104,14
L,1,5334,124,e,64,-60
L,1,5398,111,r,125,14
L,1,5523,109,s,145,36
L,1,5668,106, ,150,44
L,1,5818,99,o,68,-31
L,1,5886,78,f,90,12
L,1,5976,93, ,72,-21
L,1,6048,89,t,68,-21
L,1,6116,76,h,34,-42
L,1,6150,111,e,64,-47
L,1,6214,93, ,148,55
L,1,6362,71,u,168,97
L,1,6530,116,n,114,-2
L,1,6644,78,f,101,23
L,1,6745,136,a,198,62
L,1,6943,111,s,112,1
L,1,7055,122,c,489,367
L,1,7544,114,h,91,-23
L,1,7635,175,i,57,-118
L,1,7692,129,o,59,-70
L,1,7751,142,n,187,45
L,1,7938,127,a,233,106
L,1,8171,90,b,104,14
L,1,8275,115,l,85,-30
L,1,8360,76,e,113,37
L,1,8473,89, ,153,64
L,1,8626,109,e,88,-21
L,1,8714,185,n,250,65
L,1,8964,101,d,118,17
L,1,9082,109, ,242,133
L,1,9324,92,o,76,-16
L,1,9400,126,f,134,8
L,1,9534,103, ,107,4
L,1,9641,93,t,73,-20
L,1,9714,110,h,62,-48
L,1,9776,94,e,79,-15
L,1,9855,98, ,70,-28
L,1,9925,113,w,103,-10
L,1,10028,85,e,122,37
L,1,10150,102,s,130,28
L,1,10280,47,t,78,31
L,1,10358,128,e,58,-70
L,1,10416,134,r,94,-40
L,1,10510,127,n,115,-12
L,1,10625,125, ,126,1
L,1,10751,113,s,170,57
L,1,10921,89,p,109,20
L,1,11030,144,i,105,-39
L,1,11135,93,r,121,28
L,1,11256,153,a,98,-55
L,1,11354,102,l,110,8
L,1,11464,103, ,1059,956
L,1,12523,129,a,141,12
L,1,12664,74,r,112,38
L,1,12776,112,m,98,-14
L,1,12874,83, ,119,36
L,1,12993,93,o,27,-66
L,1,13020,96,f,100,4
L,1,13120,92, ,80,-12
L,1,13200,94,t,46,-48
L,1,13246,86,h,35,-51
L,1,13281,81,e,76,-5
L,1,13357,100, ,179,79
L,1,13536,125,G,159,34
L,1,13695,92,a,80,-12
L,1,13775,93,l,114,21
L,1,13889,116,a,302,186
L,1,14191,146,x,141,-5
L,1,14332,92,y,125,33
L,1,14457,97, ,347,250
L,1,14804,106,l,61,-45
L,1,14865,126,i,93,-33
L,1,14958,132,e,91,-41
L,1,15049,110,s,125,15
L,1,15174,99, ,92,-7
L,1,15266,130,a,149,19
L,1,15415,96, ,109,13
L,1,15524,135,s,100,-35
L,1,15624,91,m,92,1
L,1,15716,86,a,90,4
L,1,15806,79,l,115,36
L,1,15921,63,l,113,50
L,1,16034,110, ,124,14
L,1,16158,67,u,131,64
L,1,16289,120,n,119,-1
L,1,16408,100,r,103,3
L,1,16511,148,e,110,-38
L,1,16621,101,g,132,31
L,1,16753,143,a,84,-59
L,1,16837,89,r,112,23
L,1,16949,71,d,154,83
L,1,17103,105,e,84,-21
L,1,17187,163,d,186,23
L,1,17373,106, ,451,345
L,1,17824,55,y,93,38
L,1,17917,73,e,92,19
L,1,18009,231,l,260,29
L,1,18269,93,l,444,351
L,1,18713,85,w,137,52
L,1,18850,94, ,474,380
L,1,19324,96,o,74,-22
L,1,19398,62,w,62,0
L,1,19460,94, ,85,-9
L,1,19545,96,s,100,4
L,1,19645,55,u,229,174
L,1,19874,67,n,226,159
L,1,20100,122,.,650,528
L,1,20750,85,O,179,94
L,1,20929,71,r,345,274
L,1,21274,99,b,116,17
L,1,21390,100,i,142,42
L,1,21532,81,t,92,11
L,1,21624,109,i,76,-33
L,1,21700,84,n,59,-25
L,1,21759,51,g,65,14
L,1,21824,93, ,121,28
L,1,21945,95,t,18,-77
L,1,21963,96,h,161,65
L,1,22124,155,i,294,139
L,1,22418,86,s,116,30
L,1,22534,124, ,96,-28
L,1,22630,106,a,129,23
L,1,22759,139,t,25,-114
L,1,22784,115, ,582,467
L,1,23366,104,a,120,16
L,1,23486,112, ,108,-4
L,1,23594,70,d,105,35
L,1,23699,105,i,59,-46
L,1,23758,92,s,123,31
L,1,23881,77,t,88,11
L,1,23969,101,a,78,-23
L,1,24047,108,n,113,5
L,1,24160,95,c,53,-42
L,1,24213,84,e,80,-4
L,1,24293,97, ,96,-1
L,1,24389,72,o,22,-50
L,1,24411,112,f,739,627
L,1,25150,126,f,110,-16
L,1,25260,125, ,161,36
L,1,25421,80,r,51,-29
L,1,25472,130,o,67,-63
L,1,25539,83,u,147,64
L,1,25686,86,g,130,44
L,1,25816,126,h,202,76
L,1,26018,102,l,129,27
L,1,26147,106,y,109,3
L,1,26256,91, ,400,309
L,1,26656,127,n,110,-17
L,1,26766,166,i,226,60
L,1,26992,130,n,126,-4
L,1,27118,113,e,105,-8
L,1,27223,81,d,141,60
L,1,27364,80,t,107,27
L,1,27471,84,y,783,699
L,1,28254,96,t,139,43
L,1,28393,72,y,435,363
L,1,28828,84,t,206,122
L,1,29034,81,w,97,16
L,1,29131,112,o,166,54
L,1,29297,124, ,139,15
L,1,29436,116,m,126,10
L,1,29562,86,i,161,75
L,1,29723,50,i,484,434
L,1,30207,39,l,78,39
L,1,30285,70,l,153,83
L,1,30438,173,i,58,-115
L,1,30496,124,o,73,-51
L,1,30569,104,n,132,28
L,1,30701,105, ,420,315
L,1,31121,101,m,108,7
L,1,31229,129,i,55,-74
L,1,31284,129,l,61,-68
L,1,31345,126,e,190,64
L,1,31535,121,s,138,17
L,1,31673,101, ,449,348
L,1,32122,146,i,64,-82
L,1,32186,172,s,153,-19
L,1,32339,101, ,104,3
L,1,32443,92,a,34,-58
L,1,32477,100,n,96,-4
L,1,32573,64, ,47,-17
L,1,32620,97,n,772,675
L,1,33392,86,u,74,-12
L,1,33466,66,t,144,78
L,1,33610,69,t,94,25
L,1,33704,128,e,81,-47
L,1,33785,91,r,79,-12
L,1,33864,90,l,272,182
L,1,34136,113,y,132,19
L,1,34268,122, ,114,-8
L,1,34382,51,u,68,17
L,1,34450,100,s,482,382
L,1,34932,118,i,55,-63
L,1,34987,104,n,47,-57
L,1,35034,106,s,140,34
L,1,35174,128,i,42,-86
L,1,35216,109,c,516,407
L,1,35732,93,g,141,48
L,1,35873,98,n,94,-4
L,1,35967,100,i,61,-39
L,1,36028,110,c,162,52
L,1,36190,100,i,395,295
L,1,36585,99,f,94,-5
L,1,36679,97,i,90,-7
L,1,36769,132,c,149,17
L,1,36918,122,a,155,33
L,1,37073,93,n,206,113
L,1,37279,125,t,140,15
L,1,37419,131, ,1289,1158
L,1,38708,82,l,315,233
L,1,39023,76,i,127,51
L,1,39150,58,i,474,416
L,1,39624,80,t,129,49
L,1,39753,119,t,137,18
L,1,39890,89,l,77,-12
L,1,39967,107,e,76,-31
L,1,40043,93, ,129,36
L,1,40172,77,b,443,366
L,1,40615,121,l,118,-3
L,1,40733,100,u,220,120
L,1,40953,124,e,130,6
L,1,41083,92, ,81,-11
L,1,41164,60,g,141,81
L,1,41305,127,r,142,15
L,1,41447,63,e,128,65
L,1,41575,105,e,99,-6
L,1,41674,128,n,138,10
L,1,41812,129, ,116,-13
L,1,41928,84,p,128,44
L,1,42056,104,l,105,1
L,1,42161,110,a,81,-29
L,1,42242,71,n,104,33
L,1,42346,81,n,115,34
L,1,42461,91,e,590,499
L,1,43051,127,e,87,-40
L,1,43138,130,t,156,26
L,1,43294,99, ,113,14
L,1,43407,91,t,57,-34
L,1,43464,74,h,74,0
L,1,43538,109,a,59,-50
L,1,43597,104,t,805,701
L,1,44402,102,w,80,-22
L,1,44482,103,h,65,-38
L,1,44547,91,o,108,17
L,1,44655,60,e,252,192
L,1,44907,115,s,78,-37
L,1,44985,75,e,64,-11
L,1,45049,103, ,446,343
L,1,45495,126,a,78,-48
L,1,45573,90,p,277,187
L,1,45850,120,e,389,269
L,1,46239,109,d,174,65
L,1,46413,102,e,113,11
L,1,46526,125,s,135,10
L,1,46661,89,c,117,28
L,1,46778,126,e,118,-8
L,1,46896,70,n,258,188
L,1,47154,72,d,331,259
L,1,47485,98,e,81,-17
L,1,47566,141,d,142,1
L,1,47708,113, ,128,15
L,1,47836,103,l,262,159
L,1,48098,123,i,105,-18
L,1,48203,103,f,77,-26
L,1,48280,130,e,280,150
L,1,48560,96, ,108,12
L,1,48668,79,f,80,1
L,1,48748,85,o,66,-19
L,1,48814,85,r,97,12
L,1,48911,88,m,103,15
L,1,49014,111,s,118,7
L,1,49132,98, ,117,19
L,1,49249,142,a,101,-41
L,1,49350,125,r,113,-12
L,1,49463,105,e,98,-7
L,1,49561,132, ,187,55
L,1,49748,113,s,150,37
L,1,49898,105,o,132,27
L,1,50030,108, ,127,19
L,1,50157,108,a,97,-11
L,1,50254,85,m,150,65
L,1,50404,117,z,138,21
L,1,50542,124,i,63,-61
L,1,50605,101,n,72,-29
L,1,50677,78,g,69,-9
L,1,50746,83, ,936,853
L,1,51682,111,a,165,54
L,1,51847,74,z,542,468
L,1,52389,78,m,61,-17
L,1,52450,122,a,97,-25
L,1,52547,126,z,139,13
L,1,52686,114,i,58,-56
L,1,52744,128,n,70,-58
L,1,52814,107,g,75,-32
L,1,52889,86, ,100,14
L,1,52989,99,l,630,531
L,1,53619,110,l,107,-3
L,1,53726,98,y,106,8
L,1,53832,105, ,86,-19
L,1,53918,138,p,128,-10
L,1,54046,104,r,71,-33
L,1,54117,122,i,95,-27
L,1,54212,113,m,93,-20
L,1,54305,147,i,140,-7
L,1,54445,76,t,85,9
L,1,54530,169,i,105,-64
L,1,54635,126,v,94,-32
L,1,54729,148,e,166,18
L,1,54895,127, ,573,446
L,1,55468,86,t,74,-12
L,1,55542,80,h,50,-30
L,1,55592,139,a,80,-59
L,1,55672,68,t,38,-30
L,1,55710,85, ,106,21
L,1,55816,88,t,32,-56
L,1,55848,60,h,57,-3
L,1,55905,140,e,117,-23
L,1,56022,63,y,93,30
L,1,56115,102, ,573,471
L,1,56688,143,s,123,-20
L,1,56811,117,t,84,-33
L,1,56895,93,i,151,58
L,1,57046,132,l,369,237
L,1,57415,119, ,394,275
L,1,57809,128,l,111,-17
L,1,57920,98, ,110,12
L,1,58030,101,d,80,-21
L,1,58110,114,i,285,171
L,1,58395,142,g,981,839
L,1,59376,122,t,122,0
L,1,59498,91,h,56,-35
L,1,59554,148,i,84,-64
L,1,59638,146,n,114,-32
L,1,59752,114,g,105,-9
L,1,59857,107, ,732,625
L,1,60589,126,k,89,-37
L,1,60678,89, ,130,41
L,1,60808,123,d,101,-22
L,1,60909,84,i,119,35
L,1,61028,84,g,69,-15
L,1,61097,109,i,163,54
L,1,61260,98,t,133,35
L,1,61393,140,a,58,-82
L,1,61451,197,l,171,-26
L,1,61622,131, ,62,-69
L,1,61684,98,w,145,47
L,1,61829,151,a,106,-45
L,1,61935,91,t,190,99
L,1,62125,104,c,103,-1
L,1,62228,87,h,76,-11
L,1,62304,205,e,547,342
L,1,62851,125,s,151,26
L,1,63002,135, ,87,-48
L,1,63089,177,a,133,-44
L,1,63222,166,r,121,-45
L,1,63343,86,e,62,-24
L,1,63405,169,a,60,-109
L,1,63465,127, ,450,323
L,1,63915,110,p,584,474
L,1,64499,105, ,182,77
L,1,64681,133,a,154,21
L,1,64835,115, ,150,35
L,1,64985,124,p,121,-3
L,1,65106,120,r,68,-52
L,1,65174,128,e,257,129
L,1,65431,105,t,111,6
L,1,65542,133,y,485,352
L,1,66027,132,t,120,-12
L,1,66147,76,y,87,11
L,1,66234,78, ,144,66
L,1,66378,121,n,60,-61
L,1,66438,92,e,153,61
L,1,66591,142,a,105,-37
L,1,66696,121,t,104,-17
L,1,66800,98, ,179,81
L,1,66979,144,i,205,61
L,1,67184,79,d,156,77
L,1,67340,118,e,112,-6
L,1,67452,166,a,204,38
L,1,67656,152,.,796,644
L,1,68452,111,T,143,32
L,1,68595,113,h,74,-39
L,1,68669,85,i,46,-39
L,1,68715,87,s,113,26
L,1,68828,97, ,80,-17
L,1,68908,80,p,135,55
L,1,69043,90,l,118,28
L,1,69161,80,a,59,-21
L,1,69220,119,n,201,82
L,1,69421,147,e,151,4
L,1,69572,90,t,78,-12
L,1,69650,92, ,280,188
L,1,69930,136,h,110,-26
L,1,70040,160,a,86,-74
L,1,70126,111,s,81,-30
L,1,70207,109, ,480,371
L,1,70687,84,",",85,1
L,1,70772,62, ,100,38
L,1,70872,69,o,53,-16
L,1,70925,104,r,133,29
L,1,71058,146, ,133,-13
L,1,71191,104,r,107,3
L,1,71298,126,a,125,-1
L,1,71423,33,t,10,-23
L,1,71433,76,h,62,-14
L,1,71495,106,e,63,-43
L,1,71558,100,r,66,-34
L,1,71624,76, ,109,33
L,1,71733,76,h,50,-26
L,1,71783,126,a,85,-41
L,1,71868,105,d,270,165
L,1,72138,108, ,127,19
L,1,72265,103,a,75,-28
L,1,72340,96, ,97,1
L,1,72437,79,p,83,4
L,1,72520,98,r,114,16
L,1,72634,104,o,190,86
L,1,72824,108,b,126,18
L,1,72950,109,l,76,-33
L,1,73026,88,e,94,6
L,1,73120,88,m,70,-18
L,1,73190,105, ,106,1
L,1,73296,84,w,137,53
L,1,73433,100,h,81,-19
L,1,73514,123,i,215,92
L,1,73729,121,c,104,-17
L,1,73833,117,h,139,22
L,1,73972,119, ,160,41
L,1,74132,123,w,120,-3
L,1,74252,141,a,82,-59
L,1,74334,101,s,120,19
L,1,74454,94, ,669,575
L,1,75123,56,t,125,69
L,1,75248,111, ,485,374
L,1,75733,79, ,105,26
L,1,75838,85,t,42,-43
L,1,75880,124,h,60,-64
L,1,75940,84,i,16,-68
L,1,75956,102,s,458,356
L,1,76414,98,:,166,68
L,1,76580,133, ,407,274
L,1,76987,140,m,96,-44
L,1,77083,142,o,77,-65
L,1,77160,82,s,119,37
L,1,77279,109,t,115,6
L,1,77394,78, ,83,5
L,1,77477,94,o,34,-60
L,1,77511,72,f,85,13
L,1,77596,75, ,66,-9
L,1,77662,77,t,42,-35
L,1,77704,76,h,39,-37
L,1,77743,93,e,75,-18
L,1,77818,81, ,74,-7
L,1,77892,55,p,99,44
L,1,77991,95,e,22,-73
L,1,78013,77,o,141,64
L,1,78154,68,p,120,52
L,1,78274,84,l,77,-7
L,1,78351,80,e,927,847
L,1,79278,40, ,197,157
L,1,79475,127,o,86,-41
L,1,79561,106,n,77,-29
L,1,79638,110, ,142,32
L,1,79780,120,i,134,14
L,1,79914,92,t,71,-21
L,1,79985,152, ,172,20
L,1,80157,105,w,70,-35
L,1,80227,113,e,64,-49
L,1,80291,139,r,92,-47
L,1,80383,139,e,126,-13
L,1,80509,109, ,139,30
L,1,80648,71,u,142,71
L,1,80790,94,n,238,144
L,1,81028,73,h,78,5
L,1,81106,131,a,122,-9
L,1,81228,87,p,146,59
L,1,81374,87,p,158,71
L,1,81532,89,y,105,16
L,1,81637,104, ,135,31
L,1,81772,104,f,114,10
L,1,81886,97,o,94,-3
L,1,81980,90,r,93,3
L,1,82073,64, ,356,292
L,1,82429,109,p,92,-17
L,1,82521,118,r,89,-29
L,1,82610,111,e,134,23
L,1,82744,134,t,121,-13
L,1,82865,73,y,329,256
L,1,83194,88, ,107,19
L,1,83301,117,m,186,69
L,1,83487,72,u,83,11
L,1,83570,133,c,75,-58
L,1,83645,97,h,983,886
L,1,84628,137,t,402,265
L,1,85030,87,t,173,86
L,1,85203,97,y,157,60
L,1,85360,84, ,120,36
L,1,85480,78,m,134,56
L,1,85614,63,u,238,175
L,1,85852,165,c,128,-37
L,1,85980,110,h,123,13
L,1,86103,115, ,106,-9
L,1,86209,122,o,265,143
L,1,86474,116,f,115,-1
L,1,86589,107, ,102,-5
L,1,86691,93,t,34,-59
L,1,86725,98,h,67,-31
L,1,86792,122,e,48,-74
L,1,86840,97, ,112,15
L,1,86952,112,t,113,1
L,1,87065,115,i,58,-57
L,1,87123,144,m,76,-68
L,1,87199,98,e,256,158
L,1,87455,152,.,176,24
L,1,87631,134, ,433,299
L,1,88064,87,M,158,71
L,1,88222,84,a,93,9
L,1,88315,79,n,161,82
L,1,88476,56,u,72,16
L,1,88548,51,s,546,495
L,1,89094,98,y,97,-1
L,1,89191,91, ,77,-14
L,1,89268,88,s,79,-9
L,1,89347,85,o,128,43
L,1,89475,121,l,146,25
L,1,89621,107,u,10,-97
L,1,89631,112,t,622,510
L,1,90253,167,i,30,-137
L,1,90283,147,o,87,-60
L,1,90370,133,n,249,116
L,1,90619,113,s,125,12
L,1,90744,114, ,159,45
L,1,90903,118,o,412,294
L,1,91315,128,w,65,-63
L,1,91380,140,e,36,-104
L,1,91416,116,r,247,131
L,1,91663,104,e,226,122
L,1,91889,119, ,120,1
L,1,92009,70,s,113,43
L,1,92122,75,u,194,119
L,1,92316,54,g,148,94
L,1,92464,108,g,205,97
L,1,92669,107,e,66,-41
L,1,92735,132,s,190,58
L,1,92925,121,t,125,4
L,1,93050,94,e,88,-6
L,1,93138,110,d,113,3
L,1,93251,115, ,117,2
L,1,93368,101,f,80,-21
L,1,93448,115,o,105,-10
L,1,93553,67,r,42,-25
L,1,93595,75, ,90,15
L,1,93685,85,t,43,-42
L,1,93728,110,h,62,-48
L,1,93790,110,i,31,-79
L,1,93821,97,s,107,10
L,1,93928,116, ,131,15
L,1,94059,82,p,54,-28
L,1,94113,126,r,84,-42
L,1,94197,131,o,112,-19
L,1,94309,86,b,112,26
L,1,94421,140,l,133,-7
L,1,94554,81,e,44,-37
L,1,94598,110,m,212,102
L,1,94810,98, ,228,130
L,1,95038,95,",",779,684
L,1,95817,127,",",123,-4
L,1,95940,94, ,116,22
L,1,96056,72,b,136,64
L,1,96192,96,u,109,13
L,1,96301,104,t,66,-38
L,1,96367,63, ,85,22
L,1,96452,138,m,92,-46
L,1,96544,134,o,275,141
L,1,96819,109,s,126,17
L,1,96945,100,t,109,9
L,1,97054,125, ,1292,1167
L,1,98346,141,o,76,-65
L,1,98422,112,f,100,-12
L,1,98522,103, ,112,9
L,1,98634,88,t,47,-41
L,1,98681,104,h,50,-54
L,1,98731,91,e,157,66
L,1,98888,144,s,110,-34
L,1,98998,109,e,164,55
L,1,99162,148, ,406,258
L,1,99568,74,w,36,-38
L,1,99604,130,e,62,-68
L,1,99666,119,r,98,-21
L,1,99764,141,e,123,-18
L,1,99887,123, ,147,24
L,1,100034,117,s,136,19
L,1,100170,85,m,72,-13
L,1,100242,113,a,152,39
L,1,100394,42,l,90,48
L,1,100484,84,l,1369,1285
L,1,101853,109,l,81,-28
L,1,101934,185,a,127,-58
L,1,102061,126,r,154,28
L,1,102215,166,g,235,69
L,1,102450,125,e,102,-23
L,1,102552,115,l,131,16
L,1,102683,92,y,96,4
L,1,102779,124, ,301,177
L,1,103080,132,c,76,-56
L,1,103156,111,o,73,-38
L,1,103229,107,n,102,-5
L,1,103331,143,c,103,-40
L,1,103434,153,e,118,-35
L,1,103552,136,r,107,-29
L,1,103659,146,n,117,-29
L,1,103776,105,e,75,-30
L,1,103851,105,d,110,5
L,1,103961,131, ,105,-26
L,1,104066,205,w,220,15
L,1,104286,84,i,212,128
L,1,104498,94,h,369,275
L,1,104867,89,t,79,-10
L,1,104946,88,h,99,11
L,1,105045,85, ,36,-49
L,1,105081,126,t,108,-18
L,1,105189,96,h,50,-46
L,1,105239,114,e,77,-37
L,1,105316,61, ,96,35
L,1,105412,146,m,117,-29
L,1,105529,98,o,75,-23
L,1,105604,93,v,214,121
L,1,105818,106,e,139,33
L,1,105957,111,m,106,-5
L,1,106063,140,e,93,-47
L,1,106156,72,n,93,21
L,1,106249,84,t,70,-14
L,1,106319,106, ,126,20
L,1,106445,114,o,13,-101
L,1,106458,113,f,286,173
L,1,106744,152, ,122,-30
L,1,106866,117,s,138,21
L,1,107004,67,m,65,-2
L,1,107069,94,a,55,-39
L,1,107124,94,l,180,86
L,1,107304,155,l,271,116
L,1,107575,113, ,67,-46
L,1,107642,83,g,142,59
L,1,107784,119,r,80,-39
L,1,107864,283,e,376,93
L,1,108240,152,e,181,29
L,1,108421,109,n,93,-16
L,1,108514,126, ,108,-18
L,1,108622,98,p,191,93
L,1,108813,134,i,69,-65
L,1,108882,155,e,105,-50
L,1,108987,108,c,187,79
L,1,109174,156,s,488,332
L,1,109662,137,e,72,-65
L,1,109734,129,s,116,-13
L,1,109850,100, ,138,38
L,1,109988,87,o,57,-30
L,1,110045,126,f,97,-29
L,1,110142,108, ,76,-32
L,1,110218,81,p,117,36
L,1,110335,104,a,149,45
L,1,110484,96,p,180,84
L,1,110664,140,e,75,-65
L,1,110739,115,r,77,-38
L,1,110816,100,",",95,-5
L,1,110911,135, ,234,99
L,1,111145,105,w,147,42
L,1,111292,86,h,68,-18
L,1,111360,106,i,39,-67
L,1,111399,117,c,109,-8
L,1,111508,54,h,76,22
L,1,111584,97, ,77,-20
L,1,111661,110,i,59,-51
L,1,111720,87,s,97,10
L,1,111817,99, ,138,39
L,1,111955,99,o,80,-19
L,1,112035,81,d,398,317
L,1,112433,105,d,153,48
L,1,112586,61, ,111,50
L,1,112697,121,b,49,-72
L,1,112746,125,e,105,-20
L,1,112851,90,c,121,31
L,1,112972,99,a,143,44
L,1,113115,83,u,79,-4
L,1,113194,133,s,100,-33
L,1,113294,119,e,132,13
L,1,113426,120, ,239,119
L,1,113665,146,o,517,371
L,1,114182,90,n,63,-27
L,1,114245,101, ,2066,1965
L,1,116311,106,t,75,-31
L,1,116386,87,h,50,-37
L,1,116436,106,e,47,-59
L,1,116483,61,i,589,528
L,1,117072,117, ,100,-17
L,1,117172,77,w,72,-5
L,1,117244,126,h,75,-51
L,1,117319,101,o,205,104
L,1,117524,70,e,47,-23
L,1,117571,123,l,565,442
L,1,118136,135,l,85,-50
L,1,118221,101,e,72,-29
L,1,118293,88, ,126,38
L,1,118419,110,i,302,192
L,1,118721,102,t,103,1
L,1,118824,134, ,81,-53
L,1,118905,76,w,101,25
L,1,119006,145,a,63,-82
L,1,119069,119,s,115,-4
L,1,119184,154,n,208,54
L,1,119392,157,',147,-10
L,1,119539,64,t,43,-21
L,1,119582,108, ,146,38
L,1,119728,111,t,48,-63
L,1,119776,81,h,38,-43
L,1,119814,136,e,73,-63
L,1,119887,83, ,109,26
L,1,119996,102,s,114,12
L,1,120110,74,m,89,15
L,1,120199,83,a,93,10
L,1,120292,52,l,102,50
L,1,120394,76,l,94,18
L,1,120488,125, ,71,-54
L,1,120559,106,g,501,395
L,1,121060,135,r,112,-23
L,1,121172,73,e,134,61
L,1,121306,137,e,149,12
L,1,121455,76,n,73,-3
L,1,121528,148, ,139,-9
L,1,121667,113,p,584,471
L,1,122251,102,e,548,446
L,1,122799,125,i,59,-66
L,1,122858,187,e,54,-133
L,1,122912,138,c,179,41
L,1,123091,159,s,548,389
L,1,123639,144,e,75,-69
L,1,123714,131,s,144,13
L,1,123858,92, ,130,38
L,1,123988,84,o,22,-62
L,1,124010,116,f,151,35
L,1,124161,56, ,160,104
L,1,124321,57,a,450,393
L,1,124771,85,p,135,50
L,1,124906,74,a,168,94
L,1,125074,74,p,268,194
L,1,125342,145,e,104,-41
L,1,125446,110,r,592,482
L,1,126038,120, ,190,70
L,1,126228,93,w,687,594
L,1,126915,85,t,94,9
L,1,127009,88,h,31,-57
L,1,127040,122,a,129,7
L,1,127169,114,t,177,63
L,1,127346,138, ,165,27
L,1,127511,90,w,46,-44
L,1,127557,108,e,61,-47
L,1,127618,114,r,87,-27
L,1,127705,124,e,74,-50
L,1,127779,120, ,201,81
L,1,127980,57,u,151,94
L,1,128131,79,n,186,107
L,1,128317,60,h,94,34
L,1,128411,104,a,82,-22
L,1,128493,175,p,247,72
L,1,128740,120,p,242,122
L,1,128982,75,y,189,114
L,1,129171,111,.,NA,NA
L,2,371,82,I,126,44
L,2,497,123, ,195,72
L,2,692,93,t,42,-51
L,2,734,64,h,61,-3
L,2,795,117,i,91,-26
L,2,886,124,n,101,-23
L,2,987,80,k,213,133
L,2,1200,125,k,372,247
L,2,1572,87, ,93,6
L,2,1665,85,t,65,-20
L,2,1730,84,h,64,-20
L,2,1794,108,a,54,-54
L,2,1848,117,t,55,-62
L,2,1903,89, ,142,53
L,2,2045,69,m,138,69
L,2,2183,80,y,84,4
L,2,2267,92, ,96,4
L,2,2363,120,p,337,217
L,2,2700,135,f,187,52
L,2,2887,127,a,100,-27
L,2,2987,108,c,332,224
L,2,3319,105,v,136,31
L,2,3455,96,o,252,156
L,2,3707,126,r,194,68
L,2,3901,103,i,115,12
L,2,4016,108,t,118,10
L,2,4134,61,y,398,337
L,2,4532,88,e,34,-54
L,2,4566,94, ,179,85
L,2,4745,131,m,480,349
L,2,5225,121,e,145,24
L,2,5370,132,a,141,9
L,2,5511,127,l,178,51
L,2,5689,146, ,389,243
L,2,6078,92,w,61,-31
L,2,6139,126,o,73,-53
L,2,6212,126,u,116,-10
L,2,6328,126,l,73,-53
L,2,6401,95,d,128,33
L,2,6529,84, ,76,-8
L,2,6605,107,h,75,-32
L,2,6680,135,a,63,-72
L,2,6743,127,v,107,-20
L,2,6850,96,e,83,-13
L,2,6933,116, ,107,-9
L,2,7040,127,t,73,-54
L,2,7113,92,o,70,-22
L,2,7183,106, ,182,76
L,2,7365,109,b,98,-11
L,2,7463,106,e,91,-15
L,2,7554,86, ,124,38
L,2,7678,116,t,65,-51
L,2,7743,122,h,126,4
L,2,7869,124,i,101,-23
L,2,7970,97,s,102,5
L,2,8072,74, ,105,31
L,2,8177,95,o,54,-41
L,2,8231,109,n,50,-59
L,2,8281,92,e,84,-8
L,2,8365,110, ,231,121
L,2,8596,130,p,219,89
L,2,8815,170,a,98,-72
L,2,8913,118,s,150,32
L,2,9063,118,t,131,13
L,2,9194,109,a,151,42
L,2,9345,109, ,98,-11
L,2,9443,88,d,126,38
L,2,9569,82,i,30,-52
L,2,9599,108,s,312,204
L,2,9911,115,h,142,27
L,2,10053,84, ,122,38
L,2,10175,96,t,51,-45
L,2,10226,103,h,75,-28
L,2,10301,112,a,63,-49
L,2,10364,113,t,25,-88
L,2,10389,79, ,116,37
L,2,10505,90,m,172,82
L,2,10677,75,y,170,95
L,2,10847,122, ,182,60
L,2,11029,95,m,141,46
L,2,11170,113,o,71,-42
L,2,11241,105,m,180,75
L,2,11421,127, ,304,177
L,2,11725,84,e,304,220
L,2,12029,97, ,180,83
L,2,12209,102,m,152,50
L,2,12361,113,a,117,4
L,2,12478,89,k,70,-19
L,2,12548,124,e,94,-30
L,2,12642,113,s,873,760
L,2,13515,92, ,923,831
L,2,14438,101,.,392,291
L,2,14830,121, ,186,65
L,2,15016,79,I,207,128
L,2,15223,89,t,130,41
L,2,15353,71, ,115,44
L,2,15468,83,u,39,-44
L,2,15507,107,s,67,-40
L,2,15574,102,e,161,59
L,2,15735,108,s,320,212
L,2,16055,68, ,2298,2230
L,2,18353,114,b,604,490
L,2,18957,92,b,123,31
L,2,19080,130,a,50,-80
L,2,19130,122,s,219,97
L,2,19349,94,e,468,374
L,2,19817,84,i,46,-38
L,2,19863,108,c,120,12
L,2,19983,99, ,97,-2
L,2,20080,106,p,111,5
L,2,20191,88,e,110,22
L,2,20301,72,n,106,34
L,2,20407,124,n,231,107
L,2,20638,115,e,267,152
L,2,20905,128, ,123,-5
L,2,21028,66,p,431,365
L,2,21459,75,a,18,-57
L,2,21477,128,s,208,80
L,2,21685,136,t,131,-5
L,2,21816,129,a,303,174
L,2,22119,46, ,552,506
L,2,22671,80,w,33,-47
L,2,22704,120,e,259,139
L,2,22963,104,c,410,306
L,2,23373,118, ,114,-4
L,2,23487,108,c,108,0
L,2,23595,93,a,91,-2
L,2,23686,69,l,111,42
L,2,23797,67,l,80,13
L,2,23877,108, ,121,13
L,2,23998,117,i,144,27
L,2,24142,78,t,252,174
L,2,24394,135, ,598,463
L,2,24992,118,p,93,-25
L,2,25085,128,r,110,-18
L,2,25195,85,o,141,56
L,2,25336,102,p,85,-17
L,2,25421,143,e,98,-45
L,2,25519,32,r,564,532
L,2,26083,55,l,106,51
L,2,26189,73,l,119,46
L,2,26308,121,e,73,-48
L,2,26381,131,r,103,-28
L,2,26484,108, ,105,-3
L,2,26589,108,p,123,15
L,2,26712,143,a,83,-60
L,2,26795,119,s,169,50
L,2,26964,99,t,124,25
L,2,27088,129,a,628,499
L,2,27716,110, ,3214,3104
L,2,30930,145,a,47,-98
L,2,30977,114,s,115,1
L,2,31092,111, ,80,-31
L,2,31172,136,a,84,-52
L,2,31256,89, ,104,15
L,2,31360,138,m,100,-38
L,2,31460,95,a,107,12
L,2,31567,68,t,138,70
L,2,31705,55,t,661,606
L,2,32366,93,t,123,30
L,2,32489,121,e,71,-50
L,2,32560,127,r,135,8
L,2,32695,75, ,125,50
L,2,32820,81,o,61,-20
L,2,32881,95,f,76,-19
L,2,32957,102, ,528,426
L,2,33485,86,t,102,16
L,2,33587,139,r,124,-15
L,2,33711,128,a,211,83
L,2,33922,90,d,64,-26
L,2,33986,89,i,261,172
L,2,34247,118,t,87,-31
L,2,34334,196,i,37,-159
L,2,34371,134,o,78,-56
L,2,34449,126,n,751,625
L,2,35200,77, ,3753,3676
L,2,38953,92,a,105,13
L,2,39058,123,n,103,-20
L,2,39161,94,d,124,30
L,2,39285,118, ,3527,3409
L,2,42812,97,s,216,119
L,2,43028,101,p,175,74
L,2,43203,120,i,96,-24
L,2,43299,149,c,100,-49
L,2,43399,101,e,164,63
L,2,43563,103,s,158,55
L,2,43721,132, ,1655,1523
L,2,45376,94,t,76,-18
L,2,45452,109,h,92,-17
L,2,45544,134,a,76,-58
L,2,45620,132,t,175,43
L,2,45795,75, ,152,77
L,2,45947,69,m,158,89
L,2,46105,90,y,140,50
L,2,46245,81, ,96,15
L,2,46341,113,p,108,-5
L,2,46449,123,a,88,-35
L,2,46537,102,r,217,115
L,2,46754,85,e,141,56
L,2,46895,121,n,133,12
L,2,47028,76,t,173,97
L,2,47201,124, ,336,212
L,2,47537,88,s,108,20
L,2,47645,86, ,164,78
L,2,47809,79,b,113,34
L,2,47922,110,o,47,-63
L,2,47969,104,u,113,9
L,2,48082,71,t,397,326
L,2,48479,86,g,139,53
L,2,48618,83,h,114,31
L,2,48732,95,t,121,26
L,2,48853,93, ,1572,1479
L,2,50425,118,i,93,-25
L,2,50518,95,n,203,108
L,2,50721,120, ,291,171
L,2,51012,90,I,198,108
L,2,51210,81,t,125,44
L,2,51335,94,a,92,-2
L,2,51427,92,l,257,165
L,2,51684,67,y,254,187
L,2,51938,67, ,4623,4556
L,2,56561,110,d,94,-16
L,2,56655,83,u,408,325
L,2,57063,94,r,91,-3
L,2,57154,111,i,57,-54
L,2,57211,100,n,55,-45
L,2,57266,102,g,163,61
L,2,57429,86, ,95,9
L,2,57524,93,t,90,-3
L,2,57614,77,h,92,15
L,2,57706,93,e,89,-4
L,2,57795,101,i,95,-6
L,2,57890,116,r,79,-37
L,2,57969,83, ,3152,3069
L,2,61121,132,h,138,6
L,2,61259,123,o,76,-47
L,2,61335,141,n,123,-18
L,2,61458,104,e,157,53
L,2,61615,77,y,225,148
L,2,61840,99,m,115,16
L,2,61955,62,o,111,49
L,2,62066,108,o,110,2
L,2,62176,93,n,7144,7051
L,2,69320,139,o,207,68
L,2,69527,81,r,98,17
L,2,69625,95,i,117,22
L,2,69742,96,g,65,-31
L,2,69807,105,i,91,-14
L,2,69898,92,n,51,-41
L,2,69949,123,a,46,-77
L,2,69995,148,l,375,227
L,2,70370,108,l,132,24
L,2,70502,89,y,85,-4
L,2,70587,108, ,4814,4706
L,2,75401,131, ,106,-25
L,2,75507,90,a,91,1
L,2,75598,92,n,49,-43
L,2,75647,80,d,56,-24
L,2,75703,105, ,103,-2
L,2,75806,119,a,103,-16
L,2,75909,77,l,143,66
L,2,76052,92,s,75,-17
L,2,76127,100,o,98,-2
L,2,76225,121, ,518,397
L,2,76743,121,s,117,-4
L,2,76860,85,u,375,290
L,2,77235,154,n,2267,2113
L,2,79502,93,d,167,74
L,2,79669,154,r,150,-4
L,2,79819,88,i,70,-18
L,2,79889,117,e,100,-17
L,2,79989,141,d,116,-25
L,2,80105,122, ,114,-8
L,2,80219,113,p,359,246
L,2,80578,93,t,107,14
L,2,80685,80,o,56,-24
L,2,80741,96,m,140,44
L,2,80881,119,a,116,-3
L,2,80997,87,t,131,44
L,2,81128,103,o,223,120
L,2,81351,135, ,104,-31
L,2,81455,113,p,114,1
L,2,81569,117,a,70,-47
L,2,81639,85,s,148,63
L,2,81787,114,t,81,-33
L,2,81868,138,e,135,-3
L,2,82003,98, ,99,1
L,2,82102,92,a,66,-26
L,2,82168,83,n,71,-12
L,2,82239,88,d,42,-46
L,2,82281,122, ,267,145
L,2,82548,97,o,175,78
L,2,82723,75,l,193,118
L,2,82916,105,i,62,-43
L,2,82978,127,v,213,86
L,2,83191,90,e,137,47
L,2,83328,76, ,105,29
L,2,83433,113,o,278,165
L,2,83711,117,i,251,134
L,2,83962,110,l,233,123
L,2,84195,132,.,133,1
L,2,84328,91, ,244,153
L,2,84572,82,I,154,72
L,2,84726,87,t,100,13
L,2,84826,123,',92,-31
L,2,84918,77,s,93,16
L,2,85011,117, ,162,45
L,2,85173,132,r,85,-47
L,2,85258,102,e,53,-49
L,2,85311,118,a,80,-38
L,2,85391,84,l,136,52
L,2,85527,72,l,126,54
L,2,85653,116,y,687,571
L,2,86340,148, ,173,25
L,2,86513,93,g,79,-14
L,2,86592,77,o,128,51
L,2,86720,93,o,117,24
L,2,86837,116,d,87,-29
L,2,86924,106,.,921,815
L,2,87845,76, ,1303,1227
L,2,89148,94,I,1811,1717
L,2,90959,114, ,262,148
L,2,91221,85,w,46,-39
L,2,91267,108,e,131,23
L,2,91398,132, ,980,848
L,2,92378,118,W,1417,1299
L,2,93795,116,e,97,-19
L,2,93892,119, ,169,50
L,2,94061,103,p,133,30
L,2,94194,86,u,155,69
L,2,94349,104,t,143,39
L,2,94492,116, ,129,13
L,2,94621,114,p,93,-21
L,2,94714,93,a,45,-48
L,2,94759,120,r,312,192
L,2,95071,177,m,156,-21
L,2,95227,89,e,115,26
L,2,95342,120,s,220,100
L,2,95562,136,a,157,21
L,2,95719,93,n,107,14
L,2,95826,124, ,276,152
L,2,96102,98,c,77,-21
L,2,96179,114,h,79,-35
L,2,96258,89,e,149,60
L,2,96407,82,e,184,102
L,2,96591,102,s,160,58
L,2,96751,87, ,105,18
L,2,96856,93,o,59,-34
L,2,96915,72,n,518,446
L,2,97433,94,e,138,44
L,2,97571,100, ,164,64
L,2,97735,120,o,97,-23
L,2,97832,124,n,87,-37
L,2,97919,126, ,117,-9
L,2,98036,115,i,93,-22
L,2,98129,109,t,138,29
L,2,98267,133,.,787,654
L,2,99054,81, ,8256,8175
L,2,107310,61,I,412,351
L,2,107722,126, ,209,83
L,2,107931,94,w,125,31
L,2,108056,79,i,173,94
L,2,108229,67,l,203,136
L,2,108432,46,l,139,93
L,2,108571,79,l,375,296
L,2,108946,114, ,125,11
L,2,109071,112,f,140,28
L,2,109211,85,i,82,-3
L,2,109293,67,g,112,45
L,2,109405,87,u,45,-42
L,2,109450,143,r,96,-47
L,2,109546,136,e,149,13
L,2,109695,116, ,191,75
L,2,109886,93,u,54,-39
L,2,109940,101,t,2645,2544
L,2,112585,90,m,103,13
L,2,112688,102,a,97,-5
L,2,112785,88,k,58,-30
L,2,112843,88,e,81,-7
L,2,112924,103, ,144,41
L,2,113068,49,s,24,-25
L,2,113092,92,u,173,81
L,2,113265,126,r,80,-46
L,2,113345,100,e,134,34
L,2,113479,105, ,118,13
L,2,113597,94,t,83,-11
L,2,113680,97,h,76,-21
L,2,113756,113,a,62,-51
L,2,113818,110,t,70,-40
L,2,113888,89, ,116,27
L,2,114004,64,m,143,79
L,2,114147,68,y,218,150
L,2,114365,96,c,542,446
L,2,114907,139, ,154,15
L,2,115061,95,c,78,-17
L,2,115139,109,h,79,-30
L,2,115218,139,i,234,95
L,2,115452,145,l,305,160
L,2,115757,88,d,170,82
L,2,115927,106,r,101,-5
L,2,116028,101,e,125,24
L,2,116153,83,n,128,45
L,2,116281,136, ,4010,3874
L,2,120291,138,a,86,-52
L,2,120377,131,r,84,-47
L,2,120461,105,e,87,-18
L,2,120548,122, ,147,25
L,2,120695,112,a,61,-51
L,2,120756,95,b,141,46
L,2,120897,82,l,52,-30
L,2,120949,104,e,79,-25
L,2,121028,111, ,97,-14
L,2,121125,109,t,62,-47
L,2,121187,99,o,101,2
L,2,121288,113, ,175,62
L,2,121463,110,e,130,20
L,2,121593,151,a,113,-38
L,2,121706,88,t,97,9
L,2,121803,103, ,117,14
L,2,121920,132,a,379,247
L,2,122299,97,i,75,-22
L,2,122374,107,t,127,20
L,2,122501,115, ,76,-39
L,2,122577,136,a,122,-14
L,2,122699,97,s,178,81
L,2,122877,130, ,92,-38
L,2,122969,73,w,36,-37
L,2,123005,109,e,104,-5
L,2,123109,81,l,354,273
L,2,123463,92,l,200,108
L,2,123663,82,.,NA,NA
M,1,672,159,F,281,122
M,1,953,227,a,269,42
M,1,1222,157,r,216,59
M,1,1438,113, ,48180,48067
M,1,49618,144,F,556,412
M,1,50174,135,a,1219,1084
M,1,51393,111,r,175,64
M,1,51568,104, ,1107,1003
M,1,52675,63,o,316,253
M,1,52991,83,u,152,69
M,1,53143,97,t,113,16
M,1,53256,144, ,262,118
M,1,53518,139,i,250,111
M,1,53768,101,n,217,116
M,1,53985,112, ,91,-21
M,1,54076,125,t,147,22
M,1,54223,117,h,150,33
M,1,54373,129,e,132,3
M,1,54505,112, ,1335,1223
M,1,55840,127,u,263,136
M,1,56103,92,n,186,94
M,1,56289,150,c,151,1
M,1,56440,93,h,125,32
M,1,56565,148,a,800,652
M,1,57365,167,r,132,-35
M,1,57497,107,t,903,796
M,1,58400,234,e,179,-55
M,1,58579,136,d,241,105
M,1,58820,161, ,538,377
M,1,59358,91,b,159,68
M,1,59517,265,a,182,-83
M,1,59699,134,c,179,45
M,1,59878,95,k,162,67
M,1,60040,115,w,298,183
M,1,60338,121,a,144,23
M,1,60482,103,t,180,77
M,1,60662,139,e,119,-20
M,1,60781,100,r,323,223
M,1,61104,114,s,190,76
M,1,61294,75, ,266,191
M,1,61560,100,o,163,63
M,1,61723,82,f,66,-16
M,1,61789,96, ,182,86
M,1,61971,71,t,222,151
M,1,62193,90,e,67,-23
M,1,62260,128,h,1097,969
M,1,63357,102,h,165,63
M,1,63522,93,e,80,-13
M,1,63602,97, ,2631,2534
M,1,66233,99,u,211,112
M,1,66444,72,n,145,73
M,1,66589,113,f,215,102
M,1,66804,122,a,324,202
M,1,67128,27,s,48,21
M,1,67176,32,s,45,13
M,1,67221,84,h,261,177
M,1,67482,79,i,205,126
M,1,67687,78,o,242,164
M,1,67929,72,n,165,93
M,1,68094,128,a,129,1
M,1,68223,90,b,282,192
M,1,68505,64,l,146,82
M,1,68651,104,e,629,525
M,1,69280,88, ,283,195
M,1,69563,103,e,1533,1430
M,1,71096,79,n,212,133
M,1,71308,104,d,681,577
M,1,71989,135, ,633,498
M,1,72622,91,o,144,53
M,1,72766,79,f,95,16
M,1,72861,97, ,123,26
M,1,72984,87,t,105,18
M,1,73089,68,h,73,5
M,1,73162,96,e,143,47
M,1,73305,83, ,288,205
M,1,73593,200,w,141,-59
M,1,73734,110,e,270,160
M,1,74004,123,s,160,37
M,1,74164,74,t,140,66
M,1,74304,162,e,119,-43
M,1,74423,123,r,222,99
M,1,74645,59,n,199,140
M,1,74844,59, ,169,110
M,1,75013,112,s,135,23
M,1,75148,56,p,230,174
M,1,75378,18,o,1384,1366
M,1,76762,66,i,94,28
M,1,76856,112,r,97,-15
M,1,76953,31,e,497,466
M,1,77450,126,a,1701,1575
M,1,79151,63,l,154,91
M,1,79305,61, ,127,66
M,1,79432,101,a,206,105
M,1,79638,80,r,114,34
M,1,79752,48,m,150,102
M,1,79902,87, ,205,118
M,1,80107,22,o,112,90
M,1,80219,81,f,92,11
M,1,80311,96, ,223,127
M,1,80534,78,t,95,17
M,1,80629,75,h,224,149
M,1,80853,70,e,87,17
M,1,80940,45, ,623,578
M,1,81563,59,G,222,163
M,1,81785,93,a,168,75
M,1,81953,64,l,93,29
M,1,82046,74,a,569,495
M,1,82615,43,x,122,79
M,1,82737,67,y,1476,1409
M,1,84213,84, ,201,117
M,1,84414,55,l,203,148
M,1,84617,60,i,76,16
M,1,84693,75,e,321,246
M,1,85014,84,s,152,68
M,1,85166,68, ,146,78
M,1,85312,87,a,248,161
M,1,85560,52, ,639,587
M,1,86199,97,s,124,27
M,1,86323,68,m,146,78
M,1,86469,84,a,171,87
M,1,86640,43,l,169,126
M,1,86809,44,l,296,252
M,1,87105,60, ,810,750
M,1,87915,83,u,202,119
M,1,88117,64,n,155,91
M,1,88272,132,r,68,-64
M,1,88340,136,e,199,63
M,1,88539,67,g,293,226
M,1,88832,116,a,300,184
M,1,89132,62,r,225,163
M,1,89357,98,d,204,106
M,1,89561,228,e,203,-25
M,1,89764,124,d,627,503
M,1,90391,71, ,569,498
M,1,90960,62,y,153,91
M,1,91113,80,e,298,218
M,1,91411,50,l,145,95
M,1,91556,58,l,164,106
M,1,91720,72,o,127,55
M,1,91847,92,w,159,67
M,1,92006,67, ,447,380
M,1,92453,67,s,413,346
M,1,92866,84,u,221,137
M,1,93087,43,n,492,449
M,1,93579,55,.,2746,2691
M,1,96325,58,O,353,295
M,1,96678,66,r,528,462
M,1,97206,75,b,134,59
M,1,97340,68,i,132,64
M,1,97472,87,t,144,57
M,1,97616,103,i,262,159
M,1,97878,58,n,232,174
M,1,98110,53,g,695,642
M,1,98805,63, ,206,143
M,1,99011,63,t,79,16
M,1,99090,81,h,159,78
M,1,99249,104,i,156,52
M,1,99405,88,s,157,69
M,1,99562,47, ,379,332
M,1,99941,133,a,296,163
M,1,100237,51,t,495,444
M,1,100732,69, ,128,59
M,1,100860,87,a,146,59
M,1,101006,47, ,468,421
M,1,101474,86,d,770,684
M,1,102244,63,i,108,45
M,1,102352,86,s,157,71
M,1,102509,36,y,95,59
M,1,102604,97,a,168,71
M,1,102772,64,n,172,108
M,1,102944,133,c,162,29
M,1,103106,83,e,152,69
M,1,103258,60, ,221,161
M,1,103479,45,o,343,298
M,1,103822,79,f,1361,1282
M,1,105183,68, ,882,814
M,1,106065,70,r,113,43
M,1,106178,73,o,272,199
M,1,106450,66,u,409,343
M,1,106859,72,g,159,87
M,1,107018,67,h,464,397
M,1,107482,88,;,249,161
M,1,107731,63,y,1590,1527
M,1,109321,79,l,134,55
M,1,109455,63,y,171,108
M,1,109626,56, ,183,127
M,1,109809,51,.,1016,965
M,1,110825,101, ,1242,1141
M,1,112067,54,n,118,64
M,1,112185,61,e,126,65
M,1,112311,68,n,271,203
M,1,112582,95,e,772,677
M,1,113354,58,t,1757,1699
M,1,115111,75,i,184,109
M,1,115295,71,n,296,225
M,1,115591,128,e,272,144
M,1,115863,80,t,109,29
M,1,115972,64,y,537,473
M,1,116509,67,t,256,189
M,1,116765,79,w,104,25
M,1,116869,62,o,162,100
M,1,117031,67, ,1422,1355
M,1,118453,71,m,171,100
M,1,118624,67,i,231,164
M,1,118855,64,l,152,88
M,1,119007,63,l,205,142
M,1,119212,54,i,147,93
M,1,119359,91,o,220,129
M,1,119579,35,n,162,127
M,1,119741,68, ,414,346
M,1,120155,54,m,192,138
M,1,120347,70,i,221,151
M,1,120568,60,l,95,35
M,1,120663,79,e,250,171
M,1,120913,94,s,352,258
M,1,121265,101, ,720,619
M,1,121985,107,i,149,42
M,1,122134,73,s,104,31
M,1,122238,84, ,168,84
M,1,122406,87,a,150,63
M,1,122556,59,n,178,119
M,1,122734,62, ,359,297
M,1,123093,67,u,207,140
M,1,123300,51,t,161,110
M,1,123461,63,t,349,286
M,1,123810,141,e,240,99
M,1,124050,87,r,211,124
M,1,124261,95,l,205,110
M,1,124466,80,y,1894,1814
M,1,126360,74, ,406,332
M,1,126766,95,i,196,101
M,1,126962,87,n,146,59
M,1,127108,107,s,160,53
M,1,127268,79,i,255,176
M,1,127523,67,g,124,57
M,1,127647,110,n,161,51
M,1,127808,108,i,223,115
M,1,128031,80,f,116,36
M,1,128147,87,i,149,62
M,1,128296,148,c,112,-36
M,1,128408,99,a,158,59
M,1,128566,73,n,160,87
M,1,128726,76,t,226,150
M,1,128952,50, ,1006,956
M,1,129958,58,b,122,64
M,1,130080,80,l,230,150
M,1,130310,84,u,91,7
M,1,130401,92,e,174,82
M,1,130575,63, ,1032,969
M,1,131607,95,g,182,87
M,1,131789,146,r,102,-44
M,1,131891,100,e,275,175
M,1,132166,62,e,365,303
M,1,132531,95,e,1240,1145
M,1,133771,74,n,215,141
M,1,133986,63, ,249,186
M,1,134235,88,p,215,127
M,1,134450,83,l,205,122
M,1,134655,91,a,1093,1002
M,1,135748,130,a,216,86
M,1,135964,76,n,150,74
M,1,136114,103,e,259,156
M,1,136373,87,t,813,726
M,1,137186,88, ,139,51
M,1,137325,104,w,138,34
M,1,137463,104,h,139,35
M,1,137602,103,o,132,29
M,1,137734,104,s,275,171
M,1,138009,115,e,278,163
M,1,138287,124, ,345,221
M,1,138632,140,a,191,51
M,1,138823,105,p,278,173
M,1,139101,59,e,769,710
M,1,139870,135,d,132,-3
M,1,140002,115,e,296,181
M,1,140298,186,s,150,-36
M,1,140448,129,c,353,224
M,1,140801,127,e,842,715
M,1,141643,76,n,174,98
M,1,141817,106,d,86,-20
M,1,141903,165,e,247,82
M,1,142150,84,d,558,474
M,1,142708,99, ,313,214
M,1,143021,83,l,224,141
M,1,143245,96,i,145,49
M,1,143390,131,f,99,-32
M,1,143489,112,e,125,13
M,1,143614,72, ,141,69
M,1,143755,88,f,147,59
M,1,143902,108,o,132,24
M,1,144034,88,r,207,119
M,1,144241,74,m,142,68
M,1,144383,111,s,253,142
M,1,144636,71, ,862,791
M,1,145498,123,a,249,126
M,1,145747,131,r,128,-3
M,1,145875,103,e,67,-36
M,1,145942,59, ,326,267
M,1,146268,103,s,119,16
M,1,146387,80,o,1935,1855
M,1,148322,63, ,140,77
M,1,148462,111,a,152,41
M,1,148614,71,m,126,55
M,1,148740,67,a,802,735
M,1,149542,111,z,188,77
M,1,149730,111,i,217,106
M,1,149947,27,n,101,74
M,1,150048,84,g,114,30
M,1,150162,104,l,211,107
M,1,150373,71,y,184,113
M,1,150557,56, ,1632,1576
M,1,152189,87,p,180,93
M,1,152369,79,r,146,67
M,1,152515,98,i,182,84
M,1,152697,103,m,166,63
M,1,152863,90,i,175,85
M,1,153038,83,t,1080,997
M,1,154118,67,i,391,324
M,1,154509,75,v,145,70
M,1,154654,80,e,152,72
M,1,154806,47, ,1927,1880
M,1,156733,61,t,188,127
M,1,156921,79,h,163,84
M,1,157084,104,a,120,16
M,1,157204,72,t,184,112
M,1,157388,96, ,220,124
M,1,157608,84,t,129,45
M,1,157737,61,h,131,70
M,1,157868,77,e,116,39
M,1,157984,61,y,173,112
M,1,158157,76, ,419,343
M,1,158576,75,s,230,155
M,1,158806,68,t,142,74
M,1,158948,67,i,247,180
M,1,159195,44,l,126,82
M,1,159321,69,l,226,157
M,1,159547,55, ,169,114
M,1,159716,71,t,133,62
M,1,159849,88,h,231,143
M,1,160080,86,i,203,117
M,1,160283,100,n,91,-9
M,1,160374,89,k,210,121
M,1,160584,71, ,536,465
M,1,161120,74,d,568,494
M,1,161688,83,i,167,84
M,1,161855,72,g,149,77
M,1,162004,59,i,404,345
M,1,162408,76,t,262,186
M,1,162670,128,a,544,416
M,1,163214,67,l,229,162
M,1,163443,69, ,177,108
M,1,163620,51,w,418,367
M,1,164038,67,a,194,127
M,1,164232,59,t,148,89
M,1,164380,76,c,137,61
M,1,164517,77,h,117,40
M,1,164634,71,e,230,159
M,1,164864,67,s,130,63
M,1,164994,60, ,140,80
M,1,165134,91,a,911,820
M,1,166045,142,r,98,-44
M,1,166143,95,e,313,218
M,1,166456,51,a,128,77
M,1,166584,83, ,666,583
M,1,167250,101,p,202,101
M,1,167452,147,r,111,-36
M,1,167563,120,e,274,154
M,1,167837,87,t,172,85
M,1,168009,101,t,139,38
M,1,168148,119,y,650,531
M,1,168798,82, ,265,183
M,1,169063,84,n,102,18
M,1,169165,84,e,229,145
M,1,169394,108,a,149,41
M,1,169543,68,t,242,174
M,1,169785,75, ,1042,967
M,1,170827,91,i,107,16
M,1,170934,142,d,101,-41
M,1,171035,111,e,336,225
M,1,171371,89,a,173,84
M,1,171544,74,.,1878,1804
M,1,173422,66,T,246,180
M,1,173668,130,h,115,-15
M,1,173783,101,i,188,87
M,1,173971,112,s,159,47
M,1,174130,76, ,597,521
M,1,174727,66,p,185,119
M,1,174912,72,l,116,44
M,1,175028,120,a,179,59
M,1,175207,71,n,280,209
M,1,175487,94,e,265,171
M,1,175752,56,t,1122,1066
M,1,176874,78, ,413,335
M,1,177287,52,h,107,55
M,1,177394,52,s,1312,1260
M,1,178706,62,",",147,85
M,1,178853,80, ,374,294
M,1,179227,42,o,835,793
M,1,180062,83,r,164,81
M,1,180226,59, ,176,117
M,1,180402,74,r,789,715
M,1,181191,94,a,183,89
M,1,181374,64,t,208,144
M,1,181582,75,h,113,38
M,1,181695,166,e,134,-32
M,1,181829,120,r,201,81
M,1,182030,75, ,253,178
M,1,182283,99,h,187,88
M,1,182470,104,a,610,506
M,1,183080,78,d,170,92
M,1,183250,62,",",357,295
M,1,183607,54, ,250,196
M,1,183857,104,a,239,135
M,1,184096,67, ,315,248
M,1,184411,62,p,213,151
M,1,184624,63,r,126,63
M,1,184750,78,o,255,177
M,1,185005,68,b,264,196
M,1,185269,98,l,153,55
M,1,185422,83,e,279,196
M,1,185701,97,m,831,734
M,1,186532,67,",",152,85
M,1,186684,89, ,181,92
M,1,186865,59,w,103,44
M,1,186968,74,h,171,97
M,1,187139,95,i,203,108
M,1,187342,79,c,1179,1100
M,1,188521,66,h,344,278
M,1,188865,88, ,274,186
M,1,189139,84,w,279,195
M,1,189418,186,a,148,-38
M,1,189566,122,s,181,59
M,1,189747,92, ,191,99
M,1,189938,80,t,126,46
M,1,190064,115,h,119,4
M,1,190183,88,i,100,12
M,1,190283,95,s,437,342
M,1,190720,87,:,313,226
M,1,191033,71, ,259,188
M,1,191292,139,m,128,-11
M,1,191420,97,o,99,2
M,1,191519,84,s,259,175
M,1,191778,72,t,167,95
M,1,191945,56, ,598,542
M,1,192543,62,o,131,69
M,1,192674,81,f,84,3
M,1,192758,92, ,192,100
M,1,192950,69,t,102,33
M,1,193052,96,h,214,118
M,1,193266,79,e,305,226
M,1,193571,118, ,977,859
M,1,194548,91,p,144,53
M,1,194692,95,e,149,54
M,1,194841,71,o,167,96
M,1,195008,95,p,247,152
M,1,195255,90,l,130,40
M,1,195385,92,e,306,214
M,1,195691,71, ,468,397
M,1,196159,78,o,218,140
M,1,196377,67,n,164,97
M,1,196541,82, ,161,79
M,1,196702,103,i,170,67
M,1,196872,95,t,223,128
M,1,197095,16, ,637,621
M,1,197732,159,w,151,-8
M,1,197883,77,e,185,108
M,1,198068,73,r,246,173
M,1,198314,71,e,321,250
M,1,198635,88, ,359,271
M,1,198994,83,u,196,113
M,1,199190,79,n,211,132
M,1,199401,79,h,121,42
M,1,199522,109,a,181,72
M,1,199703,71,p,167,96
M,1,199870,80,p,125,45
M,1,199995,99,y,185,86
M,1,200180,69, ,1672,1603
M,1,201852,78,f,125,47
M,1,201977,58,o,105,47
M,1,202082,73,r,143,70
M,1,202225,77, ,230,153
M,1,202455,71,p,113,42
M,1,202568,121,r,559,438
M,1,203127,122,e,829,707
M,1,203956,48,t,158,110
M,1,204114,72,t,174,102
M,1,204288,96,y,222,126
M,1,204510,74, ,695,621
M,1,205205,95,m,299,204
M,1,205504,72,u,195,123
M,1,205699,71,c,125,54
M,1,205824,57,h,163,106
M,1,205987,88, ,215,127
M,1,206202,90,o,107,17
M,1,206309,76,f,150,74
M,1,206459,59, ,429,370
M,1,206888,74,t,123,49
M,1,207011,74,h,153,79
M,1,207164,93,e,104,11
M,1,207268,69, ,573,504
M,1,207841,80,t,96,16
M,1,207937,130,i,213,83
M,1,208150,83,m,177,94
M,1,208327,96,e,1206,1110
M,1,209533,63,.,151,88
M,1,209684,80, ,347,267
M,1,210031,60,M,222,162
M,1,210253,90,a,35,-55
M,1,210288,75,n,326,251
M,1,210614,76,y,1322,1246
M,1,211936,65, ,310,245
M,1,212246,87,s,167,80
M,1,212413,67,o,181,114
M,1,212594,63,l,243,180
M,1,212837,67,u,163,96
M,1,213000,70,t,331,261
M,1,213331,63,i,172,109
M,1,213503,78,o,225,147
M,1,213728,76,n,215,139
M,1,213943,59,s,795,736
M,1,214738,82, ,194,112
M,1,214932,156,w,115,-41
M,1,215047,112,e,215,103
M,1,215262,72,r,203,131
M,1,215465,62,e,125,63
M,1,215590,63, ,322,259
M,1,215912,99,s,170,71
M,1,216082,79,u,288,209
M,1,216370,48,g,124,76
M,1,216494,61,g,101,40
M,1,216595,64,e,221,157
M,1,216816,59,s,99,40
M,1,216915,65,t,152,87
M,1,217067,176,e,138,-38
M,1,217205,118,d,932,814
M,1,218137,77, ,232,155
M,1,218369,58,f,98,40
M,1,218467,80,o,117,37
M,1,218584,63,r,107,44
M,1,218691,93, ,128,35
M,1,218819,55,t,166,111
M,1,218985,63,h,80,17
M,1,219065,108,i,274,166
M,1,219339,19,s,1116,1097
M,1,220455,67, ,410,343
M,1,220865,84,p,193,109
M,1,221058,83,r,335,252
M,1,221393,91,o,207,116
M,1,221600,100,n,506,406
M,1,222106,71,b,156,85
M,1,222262,67,l,146,79
M,1,222408,67,e,369,302
M,1,222777,57,m,245,188
M,1,223022,89,",",170,81
M,1,223192,76, ,1294,1218
M,1,224486,67,b,141,74
M,1,224627,71,i,110,39
M,1,224737,76,t,108,32
M,1,224845,93, ,232,139
M,1,225077,145,m,124,-21
M,1,225201,103,o,84,-19
M,1,225285,125,s,234,109
M,1,225519,95,t,177,82
M,1,225696,68, ,1182,1114
M,1,226878,87,o,128,41
M,1,227006,56,f,109,53
M,1,227115,64, ,82,18
M,1,227197,76,t,168,92
M,1,227365,55,h,97,42
M,1,227462,88,e,328,240
M,1,227790,46,s,255,209
M,1,228045,110,e,229,119
M,1,228274,71, ,320,249
M,1,228594,173,w,172,-1
M,1,228766,88,e,186,98
M,1,228952,72,r,232,160
M,1,229184,86,e,178,92
M,1,229362,73, ,303,230
M,1,229665,75,l,114,39
M,1,229779,108,a,255,147
M,1,230034,75,r,119,44
M,1,230153,61,g,172,111
M,1,230325,84,e,216,132
M,1,230541,84,l,131,47
M,1,230672,83,y,181,98
M,1,230853,71, ,851,780
M,1,231704,67,c,113,46
M,1,231817,105,o,200,95
M,1,232017,67,n,139,72
M,1,232156,123,c,105,-18
M,1,232261,92,e,351,259
M,1,232612,71,n,1258,1187
M,1,233870,79,r,147,68
M,1,234017,79,n,166,87
M,1,234183,129,e,80,-49
M,1,234263,119,d,1822,1703
M,1,236085,93, ,178,85
M,1,236263,101,w,140,39
M,1,236403,72,i,147,75
M,1,236550,70,t,100,30
M,1,236650,40,h,185,145
M,1,236835,71, ,71,0
M,1,236906,76,t,219,143
M,1,237125,76,h,165,89
M,1,237290,71,e,123,52
M,1,237413,88, ,411,323
M,1,237824,86,m,217,131
M,1,238041,68,o,823,755
M,1,238864,71,v,154,83
M,1,239018,64,e,350,286
M,1,239368,74,m,158,84
M,1,239526,80,e,163,83
M,1,239689,51,n,64,13
M,1,239753,95,t,149,54
M,1,239902,51, ,528,477
M,1,240430,92,s,211,119
M,1,240641,78, ,1350,1272
M,1,241991,78,o,136,58
M,1,242127,68,f,120,52
M,1,242247,63, ,117,54
M,1,242364,93,a,128,35
M,1,242492,60, ,190,130
M,1,242682,90,s,140,50
M,1,242822,62,m,188,126
M,1,243010,67,a,133,66
M,1,243143,51,l,164,113
M,1,243307,72,l,235,163
M,1,243542,52, ,991,939
M,1,244533,55,g,124,69
M,1,244657,136,r,105,-31
M,1,244762,87,e,258,171
M,1,245020,44,s,177,133
M,1,245197,75,s,1058,983
M,1,246255,72,e,675,603
M,1,246930,76,n,713,637
M,1,247643,66, ,319,253
M,1,247962,84,p,294,210
M,1,248256,90,i,168,78
M,1,248424,107,e,261,154
M,1,248685,151,c,140,-11
M,1,248825,123,e,334,211
M,1,249159,106,s,269,163
M,1,249428,83, ,1045,962
M,1,250473,79,o,166,87
M,1,250639,67,f,109,42
M,1,250748,76, ,235,159
M,1,250983,83,p,147,64
M,1,251130,93,a,171,78
M,1,251301,92,p,162,70
M,1,251463,160,e,153,-7
M,1,251616,87,r,725,638
M,1,252341,75,",",134,59
M,1,252475,84, ,164,80
M,1,252639,87,w,108,21
M,1,252747,84,h,205,121
M,1,252952,100,i,428,328
M,1,253380,114,c,198,84
M,1,253578,88,h,323,235
M,1,253901,89, ,246,157
M,1,254147,106,o,258,152
M,1,254405,66,f,147,81
M,1,254552,76, ,1441,1365
M,1,255993,75,i,420,345
M,1,256413,95,s,112,17
M,1,256525,64, ,222,158
M,1,256747,66,o,175,109
M,1,256922,60,d,178,118
M,1,257100,80,d,710,630
M,1,257810,75, ,226,151
M,1,258036,64,b,85,21
M,1,258121,79,e,245,166
M,1,258366,175,c,169,-6
M,1,258535,168,a,233,65
M,1,258768,67,u,128,61
M,1,258896,103,s,258,155
M,1,259154,82,e,786,704
M,1,259940,103, ,234,131
M,1,260174,131,o,135,4
M,1,260309,64,n,173,109
M,1,260482,60, ,104,44
M,1,260586,51,t,138,87
M,1,260724,80,h,109,29
M,1,260833,92,e,114,22
M,1,260947,81, ,406,325
M,1,261353,100,w,135,35
M,1,261488,87,h,223,136
M,1,261711,87,o,210,123
M,1,261921,73,l,169,96
M,1,262090,102,e,198,96
M,1,262288,83, ,813,730
M,1,263101,79,i,128,49
M,1,263229,84,t,115,31
M,1,263344,83, ,182,99
M,1,263526,67,w,237,170
M,1,263763,119,a,479,360
M,1,264242,88,s,174,86
M,1,264416,64,n,558,494
M,1,264974,85,',183,98
M,1,265157,71,t,143,72
M,1,265300,68, ,1820,1752
M,1,267120,76,t,104,28
M,1,267224,68,h,201,133
M,1,267425,51,e,120,69
M,1,267545,67, ,845,778
M,1,268390,106,s,241,135
M,1,268631,75,m,891,816
M,1,269522,101,a,247,146
M,1,269769,32,l,151,119
M,1,269920,68,l,279,211
M,1,270199,67, ,776,709
M,1,270975,66,g,228,162
M,1,271203,107,r,445,338
M,1,271648,112,e,218,106
M,1,271866,85,e,399,314
M,1,272265,71,n,179,108
M,1,272444,89, ,320,231
M,1,272764,104,p,216,112
M,1,272980,116,e,754,638
M,1,273734,100,i,162,62
M,1,273896,116,e,258,142
M,1,274154,148,c,144,-4
M,1,274298,105,e,277,172
M,1,274575,107,s,298,191
M,1,274873,75, ,947,872
M,1,275820,67,o,141,74
M,1,275961,87,d,155,68
M,1,276116,80, ,251,171
M,1,276367,70,p,109,39
M,1,276476,109,a,194,85
M,1,276670,65,p,129,64
M,1,276799,143,e,129,-14
M,1,276928,89,r,181,92
M,1,277109,71, ,459,388
M,1,277568,72,t,99,27
M,1,277667,71,h,179,108
M,1,277846,83,a,125,42
M,1,277971,60,t,159,99
M,1,278130,69, ,149,80
M,1,278279,146,w,100,-46
M,1,278379,108,e,209,101
M,1,278588,78,r,229,151
M,1,278817,76,e,148,72
M,1,278965,85, ,1318,1233
M,1,280283,63,u,183,120
M,1,280466,70,n,252,182
M,1,280718,79,h,194,115
M,1,280912,81,a,778,697
M,1,281690,66,p,136,70
M,1,281826,67,p,86,19
M,1,281912,96,y,1514,1418
M,1,283426,103,.,NA,NA
M,2,169,90,M,294,204
M,2,463,75,y,237,162
M,2,700,85, ,203,118
M,2,903,145,f,105,-40
M,2,1008,112,a,269,157
M,2,1277,75,v,439,364
M,2,1716,68,o,187,119
M,2,1903,80,r,1424,1344
M,2,3327,94,i,190,96
M,2,3517,156,t,109,-47
M,2,3626,120,e,220,100
M,2,3846,84, ,924,840
M,2,4770,76,f,215,139
M,2,4985,56,o,149,93
M,2,5134,68,o,114,46
M,2,5248,88,d,131,43
M,2,5379,85, ,770,685
M,2,6149,55,i,302,247
M,2,6451,45,s,18795,18750
M,2,25246,64, ,334,270
M,2,25580,59,n,283,224
M,2,25863,59,o,154,95
M,2,26017,68,o,1073,1005
M,2,27090,87,d,153,66
M,2,27243,82,l,107,25
M,2,27350,84,e,156,72
M,2,27506,63, ,233,170
M,2,27739,95,s,174,79
M,2,27913,71,o,226,155
M,2,28139,54,u,544,490
M,2,28683,81,p,1235,1154
M,2,29918,75,.,214,139
M,2,30132,34, ,384,350
M,2,30516,86,T,155,69
M,2,30671,90,o,187,97
M,2,30858,52, ,173,121
M,2,31031,67,m,137,70
M,2,31168,83,a,137,54
M,2,31305,75,k,104,29
M,2,31409,64,e,101,37
M,2,31510,69, ,599,530
M,2,32109,89,i,132,43
M,2,32241,53,t,99,46
M,2,32340,52, ,1942,1890
M,2,34282,48, ,1033,985
M,2,35315,66,y,117,51
M,2,35432,84,o,234,150
M,2,35666,67,u,180,113
M,2,35846,46, ,346,300
M,2,36192,34,e,160,126
M,2,36352,63,e,1298,1235
M,2,37650,59,n,147,88
M,2,37797,64,e,218,154
M,2,38015,26,e,443,417
M,2,38458,74,d,194,120
M,2,38652,60, ,194,134
M,2,38846,59,t,88,29
M,2,38934,64,o,182,118
M,2,39116,71, ,235,164
M,2,39351,44,p,37,-7
M,2,39388,128,r,96,-32
M,2,39484,92,e,705,613
M,2,40189,59,p,155,96
M,2,40344,76,a,670,594
M,2,41014,121,r,97,-24
M,2,41111,92,e,131,39
M,2,41242,63, ,941,878
M,2,42183,48,a,126,78
M,2,42309,66, ,11210,11144
M,2,53519,78,b,392,314
M,2,53911,52,r,310,258
M,2,54221,55,o,153,98
M,2,54374,70,t,122,52
M,2,54496,56,h,3148,3092
M,2,57644,70, ,141,71
M,2,57785,84,w,143,59
M,2,57928,71,i,134,63
M,2,58062,74,t,101,27
M,2,58163,52,h,186,134
M,2,58349,75, ,608,533
M,2,58957,75,t,130,55
M,2,59087,59,h,104,45
M,2,59191,73,e,107,34
M,2,59298,60, ,415,355
M,2,59713,67,m,216,149
M,2,59929,78,e,287,209
M,2,60216,63,a,4135,4072
M,2,64351,73,m,130,57
M,2,64481,70,e,229,159
M,2,64710,136,a,288,152
M,2,64998,99,t,153,54
M,2,65151,57, ,570,513
M,2,65721,128,a,164,36
M,2,65885,70,n,143,73
M,2,66028,64,d,120,56
M,2,66148,68, ,105,37
M,2,66253,80,t,117,37
M,2,66370,49,h,95,46
M,2,66465,63,e,71,8
M,2,66536,64, ,202,138
M,2,66738,53,n,277,224
M,2,67015,43,o,135,92
M,2,67150,51,o,112,61
M,2,67262,72,d,111,39
M,2,67373,44,l,99,55
M,2,67472,69,e,207,138
M,2,67679,52,s,112,60
M,2,67791,61, ,174,113
M,2,67965,71,t,87,16
M,2,68052,65,h,131,66
M,2,68183,60,e,307,247
M,2,68490,50,s,1085,1035
M,2,69575,59,m,93,34
M,2,69668,48,s,171,123
M,2,69839,54,e,129,75
M,2,69968,63,l,610,547
M,2,70578,74,v,87,13
M,2,70665,80,e,284,204
M,2,70949,67,s,4154,4087
M,2,75103,58, ,117,59
M,2,75220,85,a,140,55
M,2,75360,55,l,177,122
M,2,75537,77,o,199,122
M,2,75736,72,n,146,74
M,2,75882,38,g,54,16
M,2,75936,65, ,266,201
M,2,76202,86,w,113,27
M,2,76315,68,i,179,111
M,2,76494,57,t,98,41
M,2,76592,58,h,199,141
M,2,76791,64, ,175,111
M,2,76966,55,s,108,53
M,2,77074,112,o,133,21
M,2,77207,64,m,97,33
M,2,77304,55,e,139,84
M,2,77443,60, ,168,108
M,2,77611,62,s,126,64
M,2,77737,76,p,967,891
M,2,78704,53,i,459,406
M,2,79163,143,c,111,-32
M,2,79274,108,e,302,194
M,2,79576,66,s,142,76
M,2,79718,78, ,234,156
M,2,79952,75,l,210,135
M,2,80162,59,i,170,111
M,2,80332,70,k,132,62
M,2,80464,71,e,140,69
M,2,80604,65, ,1044,979
M,2,81648,63,s,238,175
M,2,81886,95,a,264,169
M,2,82150,59,l,128,69
M,2,82278,71,t,1719,1648
M,2,83997,62,",",186,124
M,2,84183,47, ,228,181
M,2,84411,56,p,146,90
M,2,84557,59,e,231,172
M,2,84788,55,p,139,84
M,2,84927,84,p,109,25
M,2,85036,148,e,112,-36
M,2,85148,107,r,1133,1026
M,2,86281,63,",",158,95
M,2,86439,47, ,541,494
M,2,86980,78,p,145,67
M,2,87125,93,a,1635,1542
M,2,88760,50,p,210,160
M,2,88970,86,r,180,94
M,2,89150,51,i,184,133
M,2,89334,68,k,940,872
M,2,90274,66,a,1070,1004
M,2,91344,92,",",153,61
M,2,91497,102, ,179,77
M,2,91676,91,e,140,49
M,2,91816,63,t,271,208
M,2,92087,91,c,400,309
M,2,92487,67,.,137,70
M,2,92624,72, ,13339,13267
M,2,105963,75,F,210,135
M,2,106173,59,i,75,16
M,2,106248,85,r,235,150
M,2,106483,84,s,127,43
M,2,106610,65,t,913,848
M,2,107523,78,",",192,114
M,2,107715,59, ,260,201
M,2,107975,81,p,143,62
M,2,108118,129,r,97,-32
M,2,108215,79,e,151,72
M,2,108366,71,p,195,124
M,2,108561,70,a,989,919
M,2,109550,96,r,111,15
M,2,109661,52,e,125,73
M,2,109786,60, ,419,359
M,2,110205,60,t,155,95
M,2,110360,54,h,364,310
M,2,110724,83,e,115,32
M,2,110839,51, ,2705,2654
M,2,113544,154,b,114,-40
M,2,113658,119,r,425,306
M,2,114083,87,o,5561,5474
M,2,119644,66,b,135,69
M,2,119779,71,o,190,119
M,2,119969,70,i,232,162
M,2,120201,70,l,249,179
M,2,120450,64, ,270,206
M,2,120720,82,t,101,19
M,2,120821,60,h,112,52
M,2,120933,92,e,124,32
M,2,121057,48, ,3046,2998
M,2,124103,78,t,236,158
M,2,124339,63,h,163,100
M,2,124502,75,e,161,86
M,2,124663,63, ,301,238
M,2,124964,88,w,228,140
M,2,125192,95,a,132,37
M,2,125324,68,t,155,87
M,2,125479,124,e,81,-43
M,2,125560,99,r,125,26
M,2,125685,55, ,212,157
M,2,125897,93,a,118,25
M,2,126015,56,n,128,72
M,2,126143,83,d,120,37
M,2,126263,69, ,171,102
M,2,126434,73,t,178,105
M,2,126612,43,h,114,71
M,2,126726,79,r,145,66
M,2,126871,62,o,204,142
M,2,127075,69,u,1583,1514
M,2,128658,82,w,180,98
M,2,128838,47, ,422,375
M,2,129260,83,i,196,113
M,2,129456,52,n,152,100
M,2,129608,71, ,513,442
M,2,130121,110,s,119,9
M,2,130240,104,o,201,97
M,2,130441,35,m,94,59
M,2,130535,80,e,119,39
M,2,130654,59, ,2621,2562
M,2,133275,71,m,99,28
M,2,133374,76,e,222,146
M,2,133596,118,a,122,4
M,2,133718,66,t,166,100
M,2,133884,68, ,3343,3275
M,2,137227,111,a,151,40
M,2,137378,55,n,105,50
M,2,137483,73,d,96,23
M,2,137579,60, ,141,81
M,2,137720,67,t,88,21
M,2,137808,73,h,97,24
M,2,137905,77,e,113,36
M,2,138018,77, ,160,83
M,2,138178,67,s,172,105
M,2,138350,83,p,227,144
M,2,138577,76,i,129,53
M,2,138706,116,c,100,-16
M,2,138806,100,e,276,176
M,2,139082,76,s,2763,2687
M,2,141845,63,.,187,124
M,2,142032,63, ,314,251
M,2,142346,68,T,182,114
M,2,142528,60,h,145,85
M,2,142673,75,e,387,312
M,2,143060,60,n,1413,1353
M,2,144473,78,",",160,82
M,2,144633,61, ,437,376
M,2,145070,92,a,293,201
M,2,145363,51,d,181,130
M,2,145544,71,d,207,136
M,2,145751,84, ,152,68
M,2,145903,81,t,132,51
M,2,146035,63,h,91,28
M,2,146126,96,e,123,27
M,2,146249,64, ,551,487
M,2,146800,51,n,253,202
M,2,147053,52,o,138,86
M,2,147191,61,o,152,91
M,2,147343,51,f,508,457
M,2,147851,75,d,152,77
M,2,148003,71,l,91,20
M,2,148094,85,e,202,117
M,2,148296,96,s,143,47
M,2,148439,55, ,97,42
M,2,148536,100,a,324,224
M,2,148860,87,t,121,34
M,2,148981,63, ,129,66
M,2,149110,87,t,127,40
M,2,149237,60,h,125,65
M,2,149362,80,e,36,-44
M,2,149398,59, ,5299,5240
M,2,154697,61,e,1474,1413
M,2,156171,62,n,150,88
M,2,156321,72,d,118,46
M,2,156439,54, ,182,128
M,2,156621,91,a,140,49
M,2,156761,48,n,131,83
M,2,156892,48,d,123,75
M,2,157015,60, ,601,541
M,2,157616,88,m,167,79
M,2,157783,91,a,127,36
M,2,157910,41,k,112,71
M,2,158022,61,e,149,88
M,2,158171,58, ,209,151
M,2,158380,78,s,177,99
M,2,158557,46,u,123,77
M,2,158680,87,r,87,0
M,2,158767,73,e,110,37
M,2,158877,65, ,439,374
M,2,159316,65,t,100,35
M,2,159416,67,o,198,131
M,2,159614,58, ,1431,1373
M,2,161045,55,b,251,196
M,2,161296,86,o,232,146
M,2,161528,21,i,368,347
M,2,161896,91,l,199,108
M,2,162095,55,d,103,48
M,2,162198,56, ,492,436
M,2,162690,91,u,401,310
M,2,163091,55,n,183,128
M,2,163274,63,t,260,197
M,2,163534,70,i,620,550
M,2,164154,58,l,312,254
M,2,164466,63, ,589,526
M,2,165055,104,t,135,31
M,2,165190,83,h,187,104
M,2,165377,86,e,94,8
M,2,165471,64,y,1728,1664
M,2,167199,58, ,168,110
M,2,167367,112,a,254,142
M,2,167621,111,r,95,-16
M,2,167716,83,e,173,90
M,2,167889,43, ,180,137
M,2,168069,111,a,695,584
M,2,168764,48,l,203,155
M,2,168967,47, ,134,87
M,2,169101,123,d,99,-24
M,2,169200,108,e,152,44
M,2,169352,61,n,101,40
M,2,169453,96,t,449,353
M,2,169902,99,e,1755,1656
M,2,171657,31,.,80,49
M,2,171737,72, ,NA,NA
N,1,272,71,F,120,49
N,1,392,72,a,73,1
N,1,465,67,r,120,53
N,1,585,16, ,140,124
N,1,725,52,o,370,318
N,1,1095,77,u,139,62
N,1,1234,80, ,828,748
N,1,2062,63,t,56,-7
N,1,2118,91, ,166,75
N,1,2284,115,i,89,-26
N,1,2373,123,n,146,23
N,1,2519,91, ,124,33
N,1,2643,73,t,130,57
N,1,2773,60,h,67,7
N,1,2840,57,e,74,17
N,1,2914,81, ,835,754
N,1,3749,68,u,102,34
N,1,3851,80,n,108,28
N,1,3959,56,c,77,21
N,1,4036,64,h,104,40
N,1,4140,78,a,179,101
N,1,4319,72,r,121,49
N,1,4440,66,t,133,67
N,1,4573,83,e,228,145
N,1,4801,92,d,116,24
N,1,4917,75, ,167,92
N,1,5084,84,b,83,-1
N,1,5167,65,a,160,95
N,1,5327,96,c,333,237
N,1,5660,56,k,185,129
N,1,5845,73,w,162,89
N,1,6007,67,a,98,31
N,1,6105,59,t,110,51
N,1,6215,76,e,146,70
N,1,6361,81,r,222,141
N,1,6583,73,s,79,6
N,1,6662,69, ,111,42
N,1,6773,73,o,112,39
N,1,6885,80,f,96,16
N,1,6981,88, ,884,796
N,1,7865,108,t,142,34
N,1,8007,75,h,72,-3
N,1,8079,84,e,64,-20
N,1,8143,72, ,139,67
N,1,8282,108,u,120,12
N,1,8402,100,n,100,0
N,1,8502,84,f,491,407
N,1,8993,88,a,224,136
N,1,9217,63,s,60,-3
N,1,9277,88,h,300,212
N,1,9577,68,i,461,393
N,1,10038,56,o,178,122
N,1,10216,75,n,116,41
N,1,10332,77,a,85,8
N,1,10417,75,b,202,127
N,1,10619,76,l,72,-4
N,1,10691,82,e,108,26
N,1,10799,64, ,258,194
N,1,11057,82,e,100,18
N,1,11157,88,n,156,68
N,1,11313,63,f,756,693
N,1,12069,75,d,79,4
N,1,12148,85, ,143,58
N,1,12291,66,o,82,16
N,1,12373,87,f,105,18
N,1,12478,79, ,98,19
N,1,12576,80,t,92,12
N,1,12668,76,h,107,31
N,1,12775,88,e,72,-16
N,1,12847,64, ,144,80
N,1,12991,68,w,134,66
N,1,13125,87,e,194,107
N,1,13319,55,s,27,-28
N,1,13346,73,t,128,55
N,1,13474,88,e,166,78
N,1,13640,100,r,104,4
N,1,13744,85,n,113,28
N,1,13857,76, ,191,115
N,1,14048,75,s,75,0
N,1,14123,66,p,168,102
N,1,14291,75,i,139,64
N,1,14430,76,r,210,134
N,1,14640,74,a,102,28
N,1,14742,64,l,166,102
N,1,14908,56, ,128,72
N,1,15036,80,a,238,158
N,1,15274,89,r,144,55
N,1,15418,71,m,441,370
N,1,15859,71, ,456,385
N,1,16315,108,o,51,-57
N,1,16366,68,f,113,45
N,1,16479,79, ,103,24
N,1,16582,91,t,100,9
N,1,16682,75,h,84,9
N,1,16766,80,e,65,-15
N,1,16831,63, ,200,137
N,1,17031,75,G,151,76
N,1,17182,88,a,99,11
N,1,17281,69,l,100,31
N,1,17381,81,a,262,181
N,1,17643,76,x,203,127
N,1,17846,73,y,133,60
N,1,17979,39, ,147,108
N,1,18126,68,l,156,88
N,1,18282,75,i,59,-16
N,1,18341,77,e,174,97
N,1,18515,84,s,100,16
N,1,18615,64, ,309,245
N,1,18924,68,a,87,19
N,1,19011,56, ,112,56
N,1,19123,85,s,100,15
N,1,19223,78,m,117,39
N,1,19340,72,a,120,48
N,1,19460,51,l,129,78
N,1,19589,67,l,134,67
N,1,19723,88, ,206,118
N,1,19929,96,u,189,93
N,1,20118,72,n,173,101
N,1,20291,71,r,142,71
N,1,20433,84,e,145,61
N,1,20578,64,g,77,13
N,1,20655,75,a,181,106
N,1,20836,86,r,165,79
N,1,21001,80,d,182,102
N,1,21183,80,e,153,73
N,1,21336,91,d,92,1
N,1,21428,51, ,553,502
N,1,21981,76,y,110,34
N,1,22091,88,e,138,50
N,1,22229,73,l,134,61
N,1,22363,60,l,176,116
N,1,22539,50,o,71,21
N,1,22610,80,w,121,41
N,1,22731,76, ,116,40
N,1,22847,83,s,652,569
N,1,23499,68,u,196,128
N,1,23695,72,n,258,186
N,1,23953,61,.,1574,1513
N,1,25527,56,O,190,134
N,1,25717,64,r,99,35
N,1,25816,73,b,449,376
N,1,26265,68,i,126,58
N,1,26391,88,t,108,20
N,1,26499,75,i,263,188
N,1,26762,69,n,68,-1
N,1,26830,84,g,100,16
N,1,26930,77, ,178,101
N,1,27108,101,t,100,-1
N,1,27208,72,h,182,110
N,1,27390,68,i,636,568
N,1,28026,86,s,389,303
N,1,28415,64, ,152,88
N,1,28567,83,a,231,148
N,1,28798,26,g,119,93
N,1,28917,57, ,807,750
N,1,29724,66,t,117,51
N,1,29841,66, ,89,23
N,1,29930,101,a,101,0
N,1,30031,87, ,184,97
N,1,30215,76,d,76,0
N,1,30291,68,i,133,65
N,1,30424,86,s,122,36
N,1,30546,61,t,78,17
N,1,30624,66,a,149,83
N,1,30773,75,n,47,-28
N,1,30820,104,c,206,102
N,1,31026,67,e,59,-8
N,1,31085,72, ,108,36
N,1,31193,107,o,100,-7
N,1,31293,83,f,105,22
N,1,31398,75, ,108,33
N,1,31506,83,r,110,27
N,1,31616,64,o,153,89
N,1,31769,67,u,98,31
N,1,31867,75,g,98,23
N,1,31965,88,h,199,111
N,1,32164,76,l,235,159
N,1,32399,68,y,170,102
N,1,32569,72, ,304,232
N,1,32873,90,n,1317,1227
N,1,34190,91,n,189,98
N,1,34379,115,i,88,-27
N,1,34467,124,n,301,177
N,1,34768,92,e,196,104
N,1,34964,105,t,614,509
N,1,35578,52,y,458,406
N,1,36036,104,t,240,136
N,1,36276,83,w,51,-32
N,1,36327,80,o,579,499
N,1,36906,53, ,146,93
N,1,37052,68,m,149,81
N,1,37201,63,i,189,126
N,1,37390,46,l,116,70
N,1,37506,69,l,175,106
N,1,37681,60,i,132,72
N,1,37813,77,o,168,91
N,1,37981,72,n,105,33
N,1,38086,72, ,138,66
N,1,38224,73,m,196,123
N,1,38420,39,i,131,92
N,1,38551,84,l,91,7
N,1,38642,76,e,161,85
N,1,38803,99,s,84,-15
N,1,38887,60, ,325,265
N,1,39212,61,s,533,472
N,1,39745,89, ,587,498
N,1,40332,75,i,57,-18
N,1,40389,94,s,70,-24
N,1,40459,80, ,270,190
N,1,40729,80,a,84,4
N,1,40813,73,n,118,45
N,1,40931,93, ,679,586
N,1,41610,59,u,531,472
N,1,42141,84,t,150,66
N,1,42291,89,t,217,128
N,1,42508,92,e,165,73
N,1,42673,101,r,101,0
N,1,42774,44,l,253,209
N,1,43027,80,y,175,95
N,1,43202,64, ,526,462
N,1,43728,72,i,146,74
N,1,43874,85,n,121,36
N,1,43995,79,s,1565,1486
N,1,45560,55,i,252,197
N,1,45812,56,g,338,282
N,1,46150,80,n,183,103
N,1,46333,69,i,291,222
N,1,46624,71,f,89,18
N,1,46713,69,i,385,316
N,1,47098,92,c,201,109
N,1,47299,76,a,93,17
N,1,47392,81,n,117,36
N,1,47509,76,t,88,12
N,1,47597,56, ,2299,2243
N,1,49896,76,l,167,91
N,1,50063,68,i,106,38
N,1,50169,71,t,157,86
N,1,50326,99,t,705,606
N,1,51031,71,l,55,-16
N,1,51086,77,e,104,27
N,1,51190,70, ,506,436
N,1,51696,52,b,261,209
N,1,51957,85,l,312,227
N,1,52269,65,u,94,29
N,1,52363,77,e,97,20
N,1,52460,76, ,321,245
N,1,52781,84,g,92,8
N,1,52873,92,r,184,92
N,1,53057,70,e,156,86
N,1,53213,88,e,72,-16
N,1,53285,76,n,124,48
N,1,53409,67, ,157,90
N,1,53566,92,p,151,59
N,1,53717,95,l,84,-11
N,1,53801,75,a,163,88
N,1,53964,96,n,253,157
N,1,54217,84,e,177,93
N,1,54394,88,t,113,25
N,1,54507,63, ,817,754
N,1,55324,72,w,91,19
N,1,55415,80,h,252,172
N,1,55667,81,o,118,37
N,1,55785,64,s,178,114
N,1,55963,80,e,100,20
N,1,56063,77, ,137,60
N,1,56200,75,a,75,0
N,1,56275,72,p,123,51
N,1,56398,75,e,292,217
N,1,56690,118,d,201,83
N,1,56891,90,e,257,167
N,1,57148,126,s,560,434
N,1,57708,33,x,323,290
N,1,58031,88,e,193,105
N,1,58224,88,n,178,90
N,1,58402,108,d,1098,990
N,1,59500,90,c,190,100
N,1,59690,78,e,105,27
N,1,59795,84,n,105,21
N,1,59900,106,d,170,64
N,1,60070,96,e,167,71
N,1,60237,108,d,81,-27
N,1,60318,100, ,1679,1579
N,1,61997,72,f,110,38
N,1,62107,54,i,972,918
N,1,63079,88,l,196,108
N,1,63275,66,i,29,-37
N,1,63304,75,f,187,112
N,1,63491,45,r,383,338
N,1,63874,72,e,83,11
N,1,63957,73, ,217,144
N,1,64174,90,f,139,49
N,1,64313,77,o,145,68
N,1,64458,79,r,103,24
N,1,64561,106,m,654,548
N,1,65215,76,s,116,40
N,1,65331,76, ,1127,1051
N,1,66458,82,a,171,89
N,1,66629,68,r,135,67
N,1,66764,87,e,83,-4
N,1,66847,61, ,112,51
N,1,66959,68,s,67,-1
N,1,67026,77,o,119,42
N,1,67145,80, ,112,32
N,1,67257,68,a,75,7
N,1,67332,85,m,97,12
N,1,67429,61,a,182,121
N,1,67611,64,z,107,43
N,1,67718,59,i,161,102
N,1,67879,72,n,84,12
N,1,67963,64,g,112,48
N,1,68075,60,l,216,156
N,1,68291,59,y,150,91
N,1,68441,72, ,138,66
N,1,68579,80,p,111,31
N,1,68690,95,r,234,139
N,1,68924,58,i,153,95
N,1,69077,82,m,153,71
N,1,69230,63,i,78,15
N,1,69308,62,t,92,30
N,1,69400,79,i,83,4
N,1,69483,73,v,166,93
N,1,69649,80,e,76,-4
N,1,69725,68, ,466,398
N,1,70191,74,h,376,302
N,1,70567,91,t,120,29
N,1,70687,75,h,92,17
N,1,70779,69,a,207,138
N,1,70986,88,t,107,19
N,1,71093,64, ,121,57
N,1,71214,93,t,93,0
N,1,71307,67,h,117,50
N,1,71424,62,e,63,1
N,1,71487,76,y,128,52
N,1,71615,64, ,229,165
N,1,71844,76,s,223,147
N,1,72067,68,t,64,-4
N,1,72131,68,i,178,110
N,1,72309,56,l,121,65
N,1,72430,77,l,121,44
N,1,72551,84, ,231,147
N,1,72782,71,t,79,8
N,1,72861,80,h,120,40
N,1,72981,97,u,100,3
N,1,73081,89,n,137,48
N,1,73218,84,k,106,22
N,1,73324,87, ,2143,2056
N,1,75467,152,i,112,-40
N,1,75579,136,n,550,414
N,1,76129,79,k,162,83
N,1,76291,66, ,217,151
N,1,76508,67,d,85,18
N,1,76593,77,i,265,188
N,1,76858,73,g,84,11
N,1,76942,77,i,111,34
N,1,77053,77,t,214,137
N,1,77267,51,a,67,16
N,1,77334,65,l,107,42
N,1,77441,78, ,55,-23
N,1,77496,78,w,169,91
N,1,77665,87,a,134,47
N,1,77799,74,t,109,35
N,1,77908,82,c,99,17
N,1,78007,83,h,108,25
N,1,78115,65,e,143,78
N,1,78258,88,s,89,1
N,1,78347,55, ,386,331
N,1,78733,75,a,167,92
N,1,78900,57,r,141,84
N,1,79041,73,e,119,46
N,1,79160,50, ,75,25
N,1,79235,90,a,75,-15
N,1,79310,72, ,131,59
N,1,79441,95,p,82,-13
N,1,79523,74,r,169,95
N,1,79692,72,e,140,68
N,1,79832,88,t,195,107
N,1,80027,76,t,214,138
N,1,80241,83,y,124,41
N,1,80365,44, ,153,109
N,1,80518,76,n,110,34
N,1,80628,72,e,190,118
N,1,80818,68,a,73,5
N,1,80891,67,t,133,66
N,1,81024,75, ,162,87
N,1,81186,88,i,88,0
N,1,81274,75,d,163,88
N,1,81437,71,e,156,85
N,1,81593,92,a,77,-15
N,1,81670,96,.,989,893
N,1,82659,64,T,126,62
N,1,82785,73,h,156,83
N,1,82941,37,u,53,16
N,1,82994,81,s,107,26
N,1,83101,75, ,1124,1049
N,1,84225,100,i,76,-24
N,1,84301,92,s,36,-56
N,1,84337,76, ,120,44
N,1,84457,84,p,137,53
N,1,84594,92,l,89,-3
N,1,84683,104,a,115,11
N,1,84798,93,n,277,184
N,1,85075,91,e,150,59
N,1,85225,91,r,444,353
N,1,85669,116,t,550,434
N,1,86219,60, ,132,72
N,1,86351,48,h,32,-16
N,1,86383,100,a,204,104
N,1,86587,88,s,99,11
N,1,86686,54,",",90,36
N,1,86776,64, ,384,320
N,1,87160,56,o,93,37
N,1,87253,76,r,76,0
N,1,87329,61, ,369,308
N,1,87698,56,r,170,114
N,1,87868,95,a,751,656
N,1,88619,72,t,154,82
N,1,88773,86,h,70,-16
N,1,88843,71,e,127,56
N,1,88970,104,r,76,-28
N,1,89046,72, ,280,208
N,1,89326,83,h,67,-16
N,1,89393,81,a,308,227
N,1,89701,76,d,209,133
N,1,89910,52,",",110,58
N,1,90020,70, ,87,17
N,1,90107,101,a,103,2
N,1,90210,55, ,176,121
N,1,90386,81,p,84,3
N,1,90470,73,r,100,27
N,1,90570,72,o,90,18
N,1,90660,68,b,135,67
N,1,90795,79,l,92,13
N,1,90887,71,e,215,144
N,1,91102,82, ,2294,2212
N,1,93396,79,",",102,23
N,1,93498,79, ,220,141
N,1,93718,92,w,100,8
N,1,93818,75,h,119,44
N,1,93937,96,i,76,-20
N,1,94013,95,c,96,1
N,1,94109,83,h,136,53
N,1,94245,80, ,92,12
N,1,94337,77,w,138,61
N,1,94475,82,a,167,85
N,1,94642,76,s,315,239
N,1,94957,76, ,156,80
N,1,95113,99,t,116,17
N,1,95229,85,h,154,69
N,1,95383,74,i,79,5
N,1,95462,85,s,239,154
N,1,95701,77,:,130,53
N,1,95831,80, ,225,145
N,1,96056,59,m,152,93
N,1,96208,66,o,51,-15
N,1,96259,99,s,269,170
N,1,96528,85,t,163,78
N,1,96691,76,o,521,445
N,1,97212,64, ,125,61
N,1,97337,88,o,92,4
N,1,97429,69,f,81,12
N,1,97510,76, ,131,55
N,1,97641,86,t,98,12
N,1,97739,77,h,104,27
N,1,97843,83,e,80,-3
N,1,97923,61, ,122,61
N,1,98045,72,p,118,46
N,1,98163,73,e,75,2
N,1,98238,101,o,108,7
N,1,98346,147,p,110,-37
N,1,98456,100,l,102,2
N,1,98558,81,e,107,26
N,1,98665,79, ,635,556
N,1,99300,72,o,136,64
N,1,99436,80,n,102,22
N,1,99538,93, ,620,527
N,1,100158,65,i,59,-6
N,1,100217,72,t,56,-16
N,1,100273,68, ,190,122
N,1,100463,79,w,144,65
N,1,100607,103,e,179,76
N,1,100786,88,r,163,75
N,1,100949,96,e,74,-22
N,1,101023,84, ,351,267
N,1,101374,120,u,129,9
N,1,101503,80,n,196,116
N,1,101699,71,h,83,12
N,1,101782,65,a,120,55
N,1,101902,60,p,113,53
N,1,102015,77,p,197,120
N,1,102212,84,y,126,42
N,1,102338,72, ,204,132
N,1,102542,89,p,129,40
N,1,102671,88,r,166,78
N,1,102837,79,e,111,32
N,1,102948,61,t,125,64
N,1,103073,76,t,168,92
N,1,103241,80,y,106,26
N,1,103347,53, ,147,94
N,1,103494,63,m,222,159
N,1,103716,68,u,102,34
N,1,103818,64,c,85,21
N,1,103903,96,h,120,24
N,1,104023,72, ,161,89
N,1,104184,75,o,91,16
N,1,104275,76,f,98,22
N,1,104373,72, ,796,724
N,1,105169,99,t,79,-20
N,1,105248,85,h,182,97
N,1,105430,84, ,608,524
N,1,106038,112,e,150,38
N,1,106188,56, ,3153,3097
N,1,109341,91,f,80,-11
N,1,109421,99,o,112,13
N,1,109533,80,r,48,-32
N,1,109581,64, ,3008,2944
N,1,112589,104,t,147,43
N,1,112736,96,i,202,106
N,1,112938,53,m,85,32
N,1,113023,76,e,114,38
N,1,113137,56,.,94,38
N,1,113231,63, ,576,513
N,1,113807,71,M,138,67
N,1,113945,84,a,127,43
N,1,114072,61,n,164,103
N,1,114236,68,y,110,42
N,1,114346,63, ,108,45
N,1,114454,71,s,64,-7
N,1,114518,74,o,143,69
N,1,114661,74,l,179,105
N,1,114840,48,u,73,25
N,1,114913,36,t,86,50
N,1,114999,131,i,124,-7
N,1,115123,151,o,136,-15
N,1,115259,93,n,304,211
N,1,115563,68,s,95,27
N,1,115658,63, ,161,98
N,1,115819,72,w,156,84
N,1,115975,72,e,151,79
N,1,116126,68,r,148,80
N,1,116274,87,e,84,-3
N,1,116358,73, ,156,83
N,1,116514,60,s,128,68
N,1,116642,39,u,3,-36
N,1,116645,36,y,188,152
N,1,116833,84,g,1114,1030
N,1,117947,96,u,224,128
N,1,118171,52,g,112,60
N,1,118283,100,g,208,108
N,1,118491,72,e,176,104
N,1,118667,83,s,80,-3
N,1,118747,64,t,108,44
N,1,118855,84,e,163,79
N,1,119018,80,d,101,21
N,1,119119,80, ,326,246
N,1,119445,60,f,75,15
N,1,119520,77,o,121,44
N,1,119641,75,r,87,12
N,1,119728,68, ,145,77
N,1,119873,39,t,80,41
N,1,119953,80,h,132,52
N,1,120085,84,i,85,1
N,1,120170,82,s,78,-4
N,1,120248,73, ,182,109
N,1,120430,71,p,72,1
N,1,120502,76,r,108,32
N,1,120610,76,o,91,15
N,1,120701,73,b,134,61
N,1,120835,95,l,88,-7
N,1,120923,88,e,114,26
N,1,121037,64,m,206,142
N,1,121243,76,",",104,28
N,1,121347,76, ,182,106
N,1,121529,84,b,164,80
N,1,121693,88,u,104,16
N,1,121797,68,t,57,-11
N,1,121854,59, ,127,68
N,1,121981,76,m,161,85
N,1,122142,59,o,24,-35
N,1,122166,103,s,228,125
N,1,122394,72,t,79,7
N,1,122473,65, ,115,50
N,1,122588,72,o,84,12
N,1,122672,91,f,80,-11
N,1,122752,72, ,133,61
N,1,122885,98,t,91,-7
N,1,122976,85,h,117,32
N,1,123093,73,e,161,88
N,1,123254,72,s,152,80
N,1,123406,79,e,64,-15
N,1,123470,80, ,129,49
N,1,123599,87,w,174,87
N,1,123773,72,e,165,93
N,1,123938,128,r,208,80
N,1,124146,112,e,100,-12
N,1,124246,85, ,237,152
N,1,124483,92,l,114,22
N,1,124597,32,a,901,869
N,1,125498,80,r,106,26
N,1,125604,73,g,113,40
N,1,125717,80,e,121,41
N,1,125838,67,l,232,165
N,1,126070,64,y,128,64
N,1,126198,65, ,514,449
N,1,126712,84,c,64,-20
N,1,126776,72,o,132,60
N,1,126908,103,n,87,-16
N,1,126995,68,c,188,120
N,1,127183,68,e,143,75
N,1,127326,90,r,108,18
N,1,127434,100,n,103,3
N,1,127537,73,e,156,83
N,1,127693,92,d,92,0
N,1,127785,68, ,161,93
N,1,127946,56,w,88,32
N,1,128034,77,i,100,23
N,1,128134,89,t,118,29
N,1,128252,68,h,107,39
N,1,128359,84, ,526,442
N,1,128885,90,t,89,-1
N,1,128974,84,h,126,42
N,1,129100,76,e,77,1
N,1,129177,70, ,160,90
N,1,129337,87,m,163,76
N,1,129500,79,o,71,-8
N,1,129571,80,v,208,128
N,1,129779,72,e,410,338
N,1,130189,62,m,90,28
N,1,130279,77,e,104,27
N,1,130383,88,n,100,12
N,1,130483,64,t,257,193
N,1,130740,60,s,100,40
N,1,130840,60, ,997,937
N,1,131837,73,o,92,19
N,1,131929,64,f,98,34
N,1,132027,84, ,188,104
N,1,132215,68,s,153,85
N,1,132368,56,m,71,15
N,1,132439,60,a,116,56
N,1,132555,58,l,133,75
N,1,132688,56,l,126,70
N,1,132814,81, ,183,102
N,1,132997,99,g,198,99
N,1,133195,92,r,194,102
N,1,133389,58,e,161,103
N,1,133550,96,e,248,152
N,1,133798,72,n,124,52
N,1,133922,71, ,310,239
N,1,134232,64,p,177,113
N,1,134409,72,i,71,-1
N,1,134480,60,e,143,83
N,1,134623,84,c,207,123
N,1,134830,48,e,125,77
N,1,134955,96,s,88,-8
N,1,135043,45, ,101,56
N,1,135144,80,o,122,42
N,1,135266,83,f,119,36
N,1,135385,67, ,386,319
N,1,135771,103,p,96,-7
N,1,135867,89,a,100,11
N,1,135967,87,p,122,35
N,1,136089,86,e,161,75
N,1,136250,93,r,371,278
N,1,136621,60,",",105,45
N,1,136726,76, ,111,35
N,1,136837,80,w,212,132
N,1,137049,94,h,351,257
N,1,137400,72,i,88,16
N,1,137488,88,c,91,3
N,1,137579,68,h,103,35
N,1,137682,72, ,113,41
N,1,137795,68,i,84,16
N,1,137879,80,s,68,-12
N,1,137947,69, ,160,91
N,1,138107,76,o,75,-1
N,1,138182,72,d,178,106
N,1,138360,84,d,116,32
N,1,138476,63, ,409,346
N,1,138885,63,b,64,1
N,1,138949,75,e,200,125
N,1,139149,68,c,179,111
N,1,139328,80,a,81,1
N,1,139409,76,u,90,14
N,1,139499,93,s,179,86
N,1,139678,83,e,68,-15
N,1,139746,47, ,108,61
N,1,139854,61,o,154,93
N,1,140008,75,n,109,34
N,1,140117,68, ,85,17
N,1,140202,79,t,105,26
N,1,140307,56,h,79,23
N,1,140386,79,e,72,-7
N,1,140458,60, ,176,116
N,1,140634,68,w,85,17
N,1,140719,49,h,201,152
N,1,140920,51,o,126,75
N,1,141046,79,l,72,-7
N,1,141118,76,e,83,7
N,1,141201,65, ,113,48
N,1,141314,72,i,83,11
N,1,141397,69,t,97,28
N,1,141494,60, ,146,86
N,1,141640,79,w,168,89
N,1,141808,82,a,157,75
N,1,141965,77,s,32,-45
N,1,141997,95,n,211,116
N,1,142208,91,',84,-7
N,1,142292,80,t,92,12
N,1,142384,59, ,195,136
N,1,142579,79,t,97,18
N,1,142676,67,h,118,51
N,1,142794,59,e,51,-8
N,1,142845,61, ,401,340
N,1,143246,83,s,76,-7
N,1,143322,59,m,109,50
N,1,143431,77,a,96,19
N,1,143527,47,l,121,74
N,1,143648,73,l,112,39
N,1,143760,77, ,174,97
N,1,143934,87,g,227,140
N,1,144161,86,r,189,103
N,1,144350,79,e,154,75
N,1,144504,101,e,134,33
N,1,144638,79,n,125,46
N,1,144763,76, ,187,111
N,1,144950,76,p,211,135
N,1,145161,72,i,76,4
N,1,145237,64,e,151,87
N,1,145388,100,c,229,129
N,1,145617,68,e,150,82
N,1,145767,88,s,95,7
N,1,145862,56, ,143,87
N,1,146005,56,o,68,12
N,1,146073,84,f,87,3
N,1,146160,69, ,175,106
N,1,146335,56,p,81,25
N,1,146416,75,a,72,-3
N,1,146488,85,p,149,64
N,1,146637,81,e,148,67
N,1,146785,92,r,115,23
N,1,146900,68, ,247,179
N,1,147147,84,t,105,21
N,1,147252,77,h,127,50
N,1,147379,76,a,226,150
N,1,147605,83,t,146,63
N,1,147751,68, ,137,69
N,1,147888,71,w,144,73
N,1,148032,97,e,162,65
N,1,148194,85,r,156,71
N,1,148350,87,e,59,-28
N,1,148409,72, ,158,86
N,1,148567,96,u,156,60
N,1,148723,96,n,179,83
N,1,148902,76,h,83,7
N,1,148985,85,a,114,29
N,1,149099,60,p,117,57
N,1,149216,77,p,206,129
N,1,149422,52,y,237,185
N,1,149659,44,",",1023,979
N,1,150682,48,.,NA,NA
N,2,92,59,O,136,77
N,2,228,69,n,94,25
N,2,322,68,e,80,12
N,2,402,81, ,178,97
N,2,580,62,o,55,-7
N,2,635,61,f,81,20
N,2,716,85, ,147,62
N,2,863,80,m,297,217
N,2,1160,75, ,443,368
N,2,1603,56,y,125,69
N,2,1728,56, ,41,-15
N,2,1769,86,a,90,4
N,2,1859,69,b,531,462
N,2,2390,60,s,51,-9
N,2,2441,67,o,128,61
N,2,2569,48,l,122,74
N,2,2691,76,u,235,159
N,2,2926,108,t,738,630
N,2,3664,80,e,371,291
N,2,4035,67, ,449,382
N,2,4484,73,f,166,93
N,2,4650,88,a,396,308
N,2,5046,72,v,122,50
N,2,5168,59,o,100,41
N,2,5268,53,r,110,57
N,2,5378,68,i,245,177
N,2,5623,24,t,2266,2242
N,2,7889,52,i,90,38
N,2,7979,76,t,157,81
N,2,8136,84,e,68,-16
N,2,8204,77, ,415,338
N,2,8619,72,d,75,3
N,2,8694,65,i,80,15
N,2,8774,88,s,104,16
N,2,8878,74,h,76,2
N,2,8954,73,e,132,59
N,2,9086,87,s,95,8
N,2,9181,72, ,223,151
N,2,9404,72,i,48,-24
N,2,9452,85,s,57,-28
N,2,9509,64, ,1584,1520
N,2,11093,59,p,151,92
N,2,11244,92,i,92,0
N,2,11336,71,e,511,440
N,2,11847,72,r,188,116
N,2,12035,84,g,77,-7
N,2,12112,72,o,184,112
N,2,12296,43,i,234,191
N,2,12530,56,.,91,35
N,2,12621,93, ,1581,1488
N,2,14202,73,o,12,-61
N,2,14214,77,g,141,64
N,2,14355,72,i,208,136
N,2,14563,60,.,105,45
N,2,14668,72, ,168,96
N,2,14836,65,I,183,118
N,2,15019,71,t,108,37
N,2,15127,81,',142,61
N,2,15269,67,s,68,1
N,2,15337,68, ,142,74
N,2,15479,66,a,59,-7
N,2,15538,81, ,372,291
N,2,15910,84,t,159,75
N,2,16069,62,r,169,107
N,2,16238,73,a,163,90
N,2,16401,76,d,80,4
N,2,16481,55,i,4,-51
N,2,16485,33,u,120,87
N,2,16605,75,t,48,-27
N,2,16653,44,i,778,734
N,2,17431,88,i,96,8
N,2,17527,65,t,463,398
N,2,17990,56,o,134,78
N,2,18124,87,n,84,-3
N,2,18208,72,a,111,39
N,2,18319,52,l,76,24
N,2,18395,73, ,1941,1868
N,2,20336,56,P,117,61
N,2,20453,73,o,137,64
N,2,20590,62,l,132,70
N,2,20722,72,i,92,20
N,2,20814,88,s,60,-28
N,2,20874,72,h,99,27
N,2,20973,80, ,379,299
N,2,21352,82,d,82,0
N,2,21434,63,i,90,27
N,2,21524,88,s,100,12
N,2,21624,73,h,104,31
N,2,21728,76, ,524,448
N,2,22252,94,t,150,56
N,2,22402,62,h,86,24
N,2,22488,80,a,231,151
N,2,22719,92,t,301,209
N,2,23020,92, ,236,144
N,2,23256,63,i,63,0
N,2,23319,53,s,64,11
N,2,23383,102, ,452,350
N,2,23835,51,s,76,25
N,2,23911,97,i,109,12
N,2,24020,67,m,124,57
N,2,24144,70,i,193,123
N,2,24337,77,l,139,62
N,2,24476,92,a,333,241
N,2,24809,95,r,427,332
N,2,25236,40, ,133,93
N,2,25369,101,i,90,-11
N,2,25459,93,n,93,0
N,2,25552,78, ,193,115
N,2,25745,83,s,73,-10
N,2,25818,59,h,108,49
N,2,25926,75,a,68,-7
N,2,25994,63,p,93,30
N,2,26087,84,e,77,-7
N,2,26164,75, ,238,163
N,2,26402,77,t,102,25
N,2,26504,49,o,86,37
N,2,26590,48, ,619,571
N,2,27209,72,d,99,27
N,2,27308,73,u,250,177
N,2,27558,80,m,611,531
N,2,28169,75,p,116,41
N,2,28285,78,l,184,106
N,2,28469,87,i,79,-8
N,2,28548,88,g,216,128
N,2,28764,87,s,388,301
N,2,29152,62, ,69,7
N,2,29221,92,w,77,-15
N,2,29298,83,i,130,47
N,2,29428,91,t,84,-7
N,2,29512,80,h,124,44
N,2,29636,52, ,889,837
N,2,30525,32,d,43,11
N,2,30568,69,i,77,8
N,2,30645,84,f,152,68
N,2,30797,87,f,194,107
N,2,30991,48,e,127,79
N,2,31118,67,r,140,73
N,2,31258,74,e,77,3
N,2,31335,71,n,89,18
N,2,31424,68,t,316,248
N,2,31740,64,s,69,5
N,2,31809,85, ,700,615
N,2,32509,80, ,133,53
N,2,32642,73,k,161,88
N,2,32803,54,i,139,85
N,2,32942,70,n,63,-7
N,2,33005,64,d,158,94
N,2,33163,72,s,105,33
N,2,33268,67, ,356,289
N,2,33624,78,o,83,5
N,2,33707,46,f,8,-38
N,2,33715,32,d,73,41
N,2,33788,70, ,766,696
N,2,34554,89,f,200,111
N,2,34754,73,e,157,84
N,2,34911,92,e,33,-59
N,2,34944,80,l,144,64
N,2,35088,130,i,88,-42
N,2,35176,100,n,27,-73
N,2,35203,82,g,216,134
N,2,35419,83,s,2753,2670
N,2,38172,47,",",69,22
N,2,38241,56, ,103,47
N,2,38344,96,i,100,4
N,2,38444,68,n,83,15
N,2,38527,69,c,75,6
N,2,38602,62,l,157,95
N,2,38759,61,u,60,-1
N,2,38819,59,d,76,17
N,2,38895,107,i,63,-44
N,2,38958,113,n,86,-27
N,2,39044,71,g,59,-12
N,2,39103,73, ,1241,1168
N,2,40344,79,s,164,85
N,2,40508,76,w,178,102
N,2,40686,72,e,149,77
N,2,40835,83,e,209,126
N,2,41044,84,t,542,458
N,2,41586,75, ,216,141
N,2,41802,75,b,133,58
N,2,41935,84,u,76,-8
N,2,42011,68,t,58,-10
N,2,42069,86, ,178,92
N,2,42247,79,a,80,1
N,2,42327,63,l,109,46
N,2,42436,84,s,44,-40
N,2,42480,80,o,106,26
N,2,42586,72, ,488,416
N,2,43074,80,s,45,-35
N,2,43119,55,o,166,111
N,2,43285,86,u,53,-33
N,2,43338,85,r,8212,8127
N,2,51550,75,s,39,-36
N,2,51589,60,o,163,103
N,2,51752,92,u,92,0
N,2,51844,104,r,745,641
N,2,52589,56,.,424,368
N,2,53013,68, ,895,827
N,2,53908,68,I,870,802
N,2,54778,117,t,187,70
N,2,54965,70, ,171,101
N,2,55136,69,c,176,107
N,2,55312,68,a,73,5
N,2,55385,56,n,63,7
N,2,55448,76, ,191,115
N,2,55639,80,b,40,-40
N,2,55679,80,e,113,33
N,2,55792,49, ,164,115
N,2,55956,59,a,56,-3
N,2,56012,67,n,250,183
N,2,56262,73,t,590,517
N,2,56852,84,y,87,3
N,2,56939,80,t,63,-17
N,2,57002,93,h,124,31
N,2,57126,120,i,68,-52
N,2,57194,120,n,60,-60
N,2,57254,81,g,109,28
N,2,57363,68, ,286,218
N,2,57649,79,f,171,92
N,2,57820,84,r,51,-33
N,2,57871,116,o,114,-2
N,2,57985,95,m,103,8
N,2,58088,68, ,782,714
N,2,58870,67,b,50,-17
N,2,58920,74,e,167,93
N,2,59087,42,r,115,73
N,2,59202,95,r,142,47
N,2,59344,68,i,87,19
N,2,59431,80,e,159,79
N,2,59590,80,s,106,26
N,2,59696,96, ,118,22
N,2,59814,105,t,79,-26
N,2,59893,92,o,85,-7
N,2,59978,68, ,227,159
N,2,60205,76,p,921,845
N,2,61126,75,o,93,18
N,2,61219,83,t,217,134
N,2,61436,67,a,236,169
N,2,61672,47,t,1592,1545
N,2,63264,73,o,44,-29
N,2,63308,64,e,126,62
N,2,63434,98,s,62,-36
N,2,63496,77, ,156,79
N,2,63652,71,a,52,-19
N,2,63704,103,n,107,4
N,2,63811,84,d,33,-51
N,2,63844,88, ,7678,7590
N,2,71522,66,g,162,96
N,2,71684,67,r,56,-11
N,2,71740,72,o,161,89
N,2,71901,115,u,84,-31
N,2,71985,121,n,79,-42
N,2,72064,77,d,108,31
N,2,72172,104, ,1292,1188
N,2,73464,55,m,98,43
N,2,73562,91,e,244,153
N,2,73806,115,e,586,471
N,2,74392,56,a,169,113
N,2,74561,75,t,129,54
N,2,74690,56,.,85,29
N,2,74775,68, ,2413,2345
N,2,77188,39,Y,203,164
N,2,77391,56,o,124,68
N,2,77515,87,u,104,17
N,2,77619,61, ,78,17
N,2,77697,66,c,156,90
N,2,77853,76,a,76,0
N,2,77929,68,n,69,1
N,2,77998,90, ,3048,2958
N,2,81046,100,a,219,119
N,2,81265,60,d,143,83
N,2,81408,93,d,779,686
N,2,82187,83, ,83,0
N,2,82270,88,a,805,717
N,2,83075,100,a,84,-16
N,2,83159,69, ,285,216
N,2,83444,71,i,68,-3
N,2,83512,76,t,158,82
N,2,83670,90,t,109,19
N,2,83779,71,l,89,18
N,2,83868,76,e,876,800
N,2,84744,84,l,160,76
N,2,84904,65,i,68,3
N,2,84972,76,t,138,62
N,2,85110,93,t,100,7
N,2,85210,72,l,88,16
N,2,85298,88,e,49,-39
N,2,85347,100, ,239,139
N,2,85586,74,b,112,38
N,2,85698,83,e,3122,3039
N,2,88820,87,i,66,-21
N,2,88886,84,t,58,-26
N,2,88944,80, ,293,213
N,2,89237,67,o,65,-2
N,2,89302,70,f,85,15
N,2,89387,73, ,208,135
N,2,89595,69,s,68,-1
N,2,89663,64,o,136,72
N,2,89799,80,u,72,-8
N,2,89871,75,r,93,18
N,2,89964,65, ,100,35
N,2,90064,84,c,184,100
N,2,90248,80,r,145,65
N,2,90393,77,e,184,107
N,2,90577,84,a,76,-8
N,2,90653,77,m,77,0
N,2,90730,80, ,1302,1222
N,2,92032,64,t,32,-32
N,2,92064,89,o,106,17
N,2,92170,74, ,322,248
N,2,92492,68,t,80,12
N,2,92572,91,h,84,-7
N,2,92656,81,e,56,-25
N,2,92712,68, ,123,55
N,2,92835,80,s,268,188
N,2,93103,35,w,482,447
N,2,93585,71,e,140,69
N,2,93725,84,e,171,87
N,2,93896,76,t,76,0
N,2,93972,64, ,116,52
N,2,94088,106,o,190,84
N,2,94278,100,n,68,-32
N,2,94346,63,e,144,81
N,2,94490,95,s,84,-11
N,2,94574,62, ,139,77
N,2,94713,107,o,107,0
N,2,94820,77,r,469,392
N,2,95289,72, ,415,343
N,2,95704,75,s,78,3
N,2,95782,62,o,162,100
N,2,95944,79,m,76,-3
N,2,96020,83,e,83,0
N,2,96103,68, ,105,37
N,2,96208,88,a,56,-32
N,2,96264,88,n,146,58
N,2,96410,76,i,110,34
N,2,96520,88,m,82,-6
N,2,96602,72,a,79,7
N,2,96681,80,l,83,3
N,2,96764,89, ,390,301
N,2,97154,69,f,161,92
N,2,97315,76,a,198,122
N,2,97513,109,t,112,3
N,2,97625,62, ,897,835
N,2,98522,66,a,108,42
N,2,98630,89,n,68,-21
N,2,98698,71,d,1,-70
N,2,98699,58,f,66,8
N,2,98765,105, ,1265,1160
N,2,100030,82,b,46,-36
N,2,100076,81,a,403,322
N,2,100479,67,c,191,124
N,2,100670,129,n,116,-13
N,2,100786,105, ,680,575
N,2,101466,119,o,103,-16
N,2,101569,100,n,85,-15
N,2,101654,67, ,172,105
N,2,101826,89,b,151,62
N,2,101977,79,i,87,8
N,2,102064,93,t,234,141
N,2,102298,84,s,92,8
N,2,102390,76, ,147,71
N,2,102537,88,t,43,-45
N,2,102580,80,o,96,16
N,2,102676,64, ,160,96
N,2,102836,78,t,110,32
N,2,102946,74,h,59,-15
N,2,103005,100,e,84,-16
N,2,103089,77, ,157,80
N,2,103246,84,s,57,-27
N,2,103303,78,o,175,97
N,2,103478,109,u,68,-41
N,2,103546,101,r,440,339
N,2,103986,61, ,209,148
N,2,104195,80,o,126,46
N,2,104321,112,n,88,-24
N,2,104409,76,e,177,101
N,2,104586,84,s,79,-5
N,2,104665,96,.,95,-1
N,2,104760,80, ,348,268
N,2,105108,96,T,120,24
N,2,105228,92,h,100,8
N,2,105328,73,e,125,52
N,2,105453,85,r,184,99
N,2,105637,55,e,67,12
N,2,105704,88,',124,36
N,2,105828,88,s,68,-20
N,2,105896,123, ,459,336
N,2,106355,88,r,151,63
N,2,106506,80,e,157,77
N,2,106663,90,a,78,-12
N,2,106741,57,l,128,71
N,2,106869,94,l,217,123
N,2,107086,74,y,135,61
N,2,107221,55, ,99,44
N,2,107320,83,n,144,61
N,2,107464,71,o,101,30
N,2,107565,64, ,240,176
N,2,107805,60,l,153,93
N,2,107958,120,i,100,-20
N,2,108058,112,m,178,66
N,2,108236,101,i,96,-5
N,2,108332,92,t,95,3
N,2,108427,69, ,275,206
N,2,108702,102,t,59,-43
N,2,108761,64,o,84,20
N,2,108845,57, ,179,122
N,2,109024,87,w,55,-32
N,2,109079,88,h,107,19
N,2,109186,102,a,226,124
N,2,109412,83,t,64,-19
N,2,109476,77, ,160,83
N,2,109636,67,y,179,112
N,2,109815,56,o,122,66
N,2,109937,84,u,87,3
N,2,110024,72, ,65,-7
N,2,110089,59,c,148,89
N,2,110237,100,a,45,-55
N,2,110282,104,n,98,-6
N,2,110380,80, ,131,51
N,2,110511,92,d,33,-59
N,2,110544,72,o,94,22
N,2,110638,80, ,108,28
N,2,110746,56,w,286,230
N,2,111032,92,i,307,215
N,2,111339,60,h,53,-7
N,2,111392,79,t,63,-16
N,2,111455,80, ,433,353
N,2,111888,67,i,51,-16
N,2,111939,81,t,148,67
N,2,112087,57,.,NA,NA
O,1,125,78,F,184,106
O,1,309,76,a,118,42
O,1,427,64,r,216,152
O,1,643,95, ,904,809
O,1,1547,80,o,209,129
O,1,1756,63,u,120,57
O,1,1876,70,t,87,17
O,1,1963,79, ,200,121
O,1,2163,66,i,173,107
O,1,2336,56,n,162,106
O,1,2498,76, ,86,10
O,1,2584,60,t,84,24
O,1,2668,72,h,106,34
O,1,2774,60,e,60,0
O,1,2834,72, ,146,74
O,1,2980,68,g,182,114
O,1,3162,52,a,147,95
O,1,3309,64,l,96,32
O,1,3405,48,a,584,536
O,1,3989,60,x,80,20
O,1,4069,64,y,217,153
O,1,4286,72, ,5227,5155
O,1,9513,81, ,425,344
O,1,9938,59,u,166,107
O,1,10104,64,n,138,74
O,1,10242,57,c,117,60
O,1,10359,77,h,165,88
O,1,10524,56,a,107,51
O,1,10631,58,r,154,96
O,1,10785,48,t,71,23
O,1,10856,68,e,182,114
O,1,11038,76,d,122,46
O,1,11160,58, ,279,221
O,1,11439,52,b,94,42
O,1,11533,51,a,193,142
O,1,11726,50,c,124,74
O,1,11850,58,k,1067,1009
O,1,12917,64,w,227,163
O,1,13144,79,a,91,12
O,1,13235,78,t,347,269
O,1,13582,41,e,376,335
O,1,13958,69,r,102,33
O,1,14060,65,s,29704,29639
O,1,43764,85, ,216,131
O,1,43980,64,o,166,102
O,1,44146,64,f,60,-4
O,1,44206,80, ,176,96
O,1,44382,56,t,56,0
O,1,44438,60,h,156,96
O,1,44594,56,e,88,32
O,1,44682,77, ,226,149
O,1,44908,56,u,127,71
O,1,45035,77,n,128,51
O,1,45163,53,f,233,180
O,1,45396,60,a,200,140
O,1,45596,68,s,117,49
O,1,45713,64,h,222,158
O,1,45935,37,i,152,115
O,1,46087,69,o,179,110
O,1,46266,68,n,144,76
O,1,46410,61,a,96,35
O,1,46506,57,b,248,191
O,1,46754,69,l,131,62
O,1,46885,65,e,128,63
O,1,47013,76, ,1174,1098
O,1,48187,72,e,118,46
O,1,48305,68,n,103,35
O,1,48408,81,d,104,23
O,1,48512,57, ,154,97
O,1,48666,60,o,131,71
O,1,48797,64,f,76,12
O,1,48873,88, ,137,49
O,1,49010,60,t,74,14
O,1,49084,80,h,144,64
O,1,49228,76,e,108,32
O,1,49336,56, ,604,548
O,1,49940,112,w,286,174
O,1,50226,80,e,305,225
O,1,50531,108,s,172,64
O,1,50703,65,t,160,95
O,1,50863,89,e,190,101
O,1,51053,68,r,142,74
O,1,51195,60,n,267,207
O,1,51462,64, ,541,477
O,1,52003,64,s,89,25
O,1,52092,76,p,204,128
O,1,52296,64,i,121,57
O,1,52417,40,r,995,955
O,1,53412,52,a,161,109
O,1,53573,64,l,198,134
O,1,53771,68, ,395,327
O,1,54166,70,a,237,167
O,1,54403,76,r,141,65
O,1,54544,64,m,1314,1250
O,1,55858,80, ,445,365
O,1,56303,68,o,172,104
O,1,56475,88,f,126,38
O,1,56601,76, ,108,32
O,1,56709,56,t,97,41
O,1,56806,56,h,74,18
O,1,56880,68,e,94,26
O,1,56974,80, ,383,303
O,1,57357,51,G,396,345
O,1,57753,76,a,163,87
O,1,57916,56,l,144,88
O,1,58060,56,a,330,274
O,1,58390,72,x,170,98
O,1,58560,36,y,507,471
O,1,59067,82, ,415,333
O,1,59482,85,l,207,122
O,1,59689,74,i,119,45
O,1,59808,62,e,214,152
O,1,60022,57,s,95,38
O,1,60117,62, ,148,86
O,1,60265,60,a,117,57
O,1,60382,65, ,143,78
O,1,60525,60,s,134,74
O,1,60659,64,m,138,74
O,1,60797,57,a,128,71
O,1,60925,50,l,137,87
O,1,61062,65,l,242,177
O,1,61304,66, ,350,284
O,1,61654,60,u,215,155
O,1,61869,60,n,597,537
O,1,62466,52,r,168,116
O,1,62634,54,e,126,72
O,1,62760,62,g,129,67
O,1,62889,62,a,131,69
O,1,63020,66,r,111,45
O,1,63131,58,d,130,72
O,1,63261,66,e,200,134
O,1,63461,64,d,114,50
O,1,63575,100, ,197,97
O,1,63772,56,y,95,39
O,1,63867,64,e,189,125
O,1,64056,45,l,125,80
O,1,64181,68,l,151,83
O,1,64332,65,o,144,79
O,1,64476,72,w,164,92
O,1,64640,68, ,306,238
O,1,64946,83,s,220,137
O,1,65166,73,u,270,197
O,1,65436,56,n,804,748
O,1,66240,54,.,1307,1253
O,1,67547,59,O,336,277
O,1,67883,73,r,191,118
O,1,68074,52,b,172,120
O,1,68246,69,i,148,79
O,1,68394,62,t,116,54
O,1,68510,64,i,534,470
O,1,69044,68,n,135,67
O,1,69179,77,g,166,89
O,1,69345,77, ,467,390
O,1,69812,73,t,125,52
O,1,69937,72,h,133,61
O,1,70070,73,i,124,51
O,1,70194,65,s,101,36
O,1,70295,88, ,179,91
O,1,70474,48,a,114,66
O,1,70588,53,t,143,90
O,1,70731,91, ,146,55
O,1,70877,57,a,92,35
O,1,70969,69, ,637,568
O,1,71606,73,d,108,35
O,1,71714,70,i,134,64
O,1,71848,64,s,132,68
O,1,71980,62,t,146,84
O,1,72126,52,a,119,67
O,1,72245,76,n,117,41
O,1,72362,80,c,195,115
O,1,72557,85,e,638,553
O,1,73195,80, ,241,161
O,1,73436,69,o,374,305
O,1,73810,76,f,140,64
O,1,73950,80, ,227,147
O,1,74177,64,r,124,60
O,1,74301,77,o,184,107
O,1,74485,73,u,99,26
O,1,74584,68,g,124,56
O,1,74708,56,h,285,229
O,1,74993,69,l,119,50
O,1,75112,57,y,166,109
O,1,75278,62, ,446,384
O,1,75724,68,n,148,80
O,1,75872,64,i,126,62
O,1,75998,56,n,60,4
O,1,76058,64,e,219,155
O,1,76277,48,t,124,76
O,1,76401,68,y,1453,1385
O,1,77854,61,t,167,106
O,1,78021,66,w,140,74
O,1,78161,71,o,219,148
O,1,78380,62, ,200,138
O,1,78580,80,m,173,93
O,1,78753,53,i,204,151
O,1,78957,52,l,127,75
O,1,79084,68,l,219,151
O,1,79303,52,i,184,132
O,1,79487,58,o,244,186
O,1,79731,40,n,211,171
O,1,79942,64, ,379,315
O,1,80321,71,m,161,90
O,1,80482,50,i,181,131
O,1,80663,73,l,86,13
O,1,80749,73,e,248,175
O,1,80997,51,s,164,113
O,1,81161,84, ,1796,1712
O,1,82957,87,i,124,37
O,1,83081,81,s,141,60
O,1,83222,80, ,201,121
O,1,83423,80,a,127,47
O,1,83550,60,n,187,127
O,1,83737,60, ,1057,997
O,1,84794,78,u,337,259
O,1,85131,64,t,116,52
O,1,85247,63,t,117,54
O,1,85364,80,e,167,87
O,1,85531,76,r,179,103
O,1,85710,74,l,149,75
O,1,85859,56,y,118,62
O,1,85977,80, ,4733,4653
O,1,90710,66,i,172,106
O,1,90882,73,n,333,260
O,1,91215,61,s,116,55
O,1,91331,72,i,144,72
O,1,91475,46,g,215,169
O,1,91690,56,n,163,107
O,1,91853,71,i,128,57
O,1,91981,63,f,109,46
O,1,92090,70,i,180,110
O,1,92270,49,c,241,192
O,1,92511,60,a,128,68
O,1,92639,68,n,128,60
O,1,92767,45,t,104,59
O,1,92871,57, ,2030,1973
O,1,94901,84,l,178,94
O,1,95079,65,i,93,28
O,1,95172,60,t,161,101
O,1,95333,62,t,188,126
O,1,95521,60,l,68,8
O,1,95589,49,e,316,267
O,1,95905,42, ,1329,1287
O,1,97234,54,b,109,55
O,1,97343,86,l,220,134
O,1,97563,59,u,89,30
O,1,97652,57,e,119,62
O,1,97771,79, ,191,112
O,1,97962,60,g,154,94
O,1,98116,65,r,92,27
O,1,98208,74,e,190,116
O,1,98398,64,e,160,96
O,1,98558,72,n,236,164
O,1,98794,60, ,888,828
O,1,99682,85,p,180,95
O,1,99862,38,l,183,145
O,1,100045,90,a,143,53
O,1,100188,66,n,568,502
O,1,100756,130,e,173,43
O,1,100929,80,t,1026,946
O,1,101955,80, ,415,335
O,1,102370,68,w,110,42
O,1,102480,97,h,190,93
O,1,102670,64,o,85,21
O,1,102755,102,s,217,115
O,1,102972,54,e,140,86
O,1,103112,72, ,504,432
O,1,103616,69,a,102,33
O,1,103718,72,p,106,34
O,1,103824,72,e,392,320
O,1,104216,77,d,162,85
O,1,104378,81,e,218,137
O,1,104596,68,s,214,146
O,1,104810,28,c,176,148
O,1,104986,46,e,122,76
O,1,105108,65,n,120,55
O,1,105228,66,d,168,102
O,1,105396,76,e,220,144
O,1,105616,60,d,235,175
O,1,105851,74, ,1160,1086
O,1,107011,84,l,168,84
O,1,107179,71,i,109,38
O,1,107288,54,f,160,106
O,1,107448,60,e,100,40
O,1,107548,77, ,116,39
O,1,107664,76,f,143,67
O,1,107807,71,o,68,-3
O,1,107875,98,r,236,138
O,1,108111,60,m,569,509
O,1,108680,65,s,982,917
O,1,109662,101, ,202,101
O,1,109864,70,a,108,38
O,1,109972,73,r,98,25
O,1,110070,69,e,104,35
O,1,110174,91, ,119,28
O,1,110293,67,s,115,48
O,1,110408,61,o,154,93
O,1,110562,84, ,334,250
O,1,110896,61,a,73,12
O,1,110969,73,m,106,33
O,1,111075,56,a,610,554
O,1,111685,44,z,131,87
O,1,111816,70,i,145,75
O,1,111961,59,n,80,21
O,1,112041,50,g,153,103
O,1,112194,75,l,202,127
O,1,112396,42,y,981,939
O,1,113377,73, ,1735,1662
O,1,115112,72,p,191,119
O,1,115303,75,r,127,52
O,1,115430,61,i,168,107
O,1,115598,85,m,160,75
O,1,115758,68,i,262,194
O,1,116020,62,t,209,147
O,1,116229,69,i,171,102
O,1,116400,68,v,135,67
O,1,116535,65,e,82,17
O,1,116617,77, ,270,193
O,1,116887,95,t,253,158
O,1,117140,95,h,162,67
O,1,117302,57,a,61,4
O,1,117363,65,t,177,112
O,1,117540,97, ,206,109
O,1,117746,68,t,56,-12
O,1,117802,68,h,170,102
O,1,117972,55,e,63,8
O,1,118035,49,y,175,126
O,1,118210,73, ,113,40
O,1,118323,64,s,96,32
O,1,118419,48,t,219,171
O,1,118638,53,i,197,144
O,1,118835,65,l,141,76
O,1,118976,78,l,173,95
O,1,119149,89, ,138,49
O,1,119287,59,t,118,59
O,1,119405,60,h,165,105
O,1,119570,52,i,149,97
O,1,119719,75,n,141,66
O,1,119860,65,k,156,91
O,1,120016,70, ,154,84
O,1,120170,50,d,62,12
O,1,120232,87,i,149,62
O,1,120381,68,g,111,43
O,1,120492,64,i,524,460
O,1,121016,55,t,692,637
O,1,121708,71,a,130,59
O,1,121838,77,l,210,133
O,1,122048,70, ,334,264
O,1,122382,64,w,225,161
O,1,122607,61,a,115,54
O,1,122722,62,t,106,44
O,1,122828,68,c,138,70
O,1,122966,75,h,127,52
O,1,123093,53,e,226,173
O,1,123319,62,s,147,85
O,1,123466,68, ,87,19
O,1,123553,85,a,169,84
O,1,123722,63,r,104,41
O,1,123826,63,e,296,233
O,1,124122,75, ,131,56
O,1,124253,52,a,116,64
O,1,124369,64, ,879,815
O,1,125248,72,p,140,68
O,1,125388,70,r,187,117
O,1,125575,60,e,44,-16
O,1,125619,44,t,134,90
O,1,125753,49,t,158,109
O,1,125911,63,y,163,100
O,1,126074,61, ,156,95
O,1,126230,76,n,102,26
O,1,126332,60,e,218,158
O,1,126550,61,a,43,-18
O,1,126593,73,t,148,75
O,1,126741,107, ,232,125
O,1,126973,72,i,56,-16
O,1,127029,87,d,198,111
O,1,127227,56,e,250,194
O,1,127477,56,a,642,586
O,1,128119,54,.,1322,1268
O,1,129441,58,T,195,137
O,1,129636,71,h,167,96
O,1,129803,74,i,97,23
O,1,129900,70,s,102,32
O,1,130002,68, ,209,141
O,1,130211,82,p,182,100
O,1,130393,65,l,118,53
O,1,130511,82,a,117,35
O,1,130628,88,n,152,64
O,1,130780,60,e,124,64
O,1,130904,56,t,184,128
O,1,131088,88, ,294,206
O,1,131382,68,h,129,61
O,1,131511,75,a,183,108
O,1,131694,72,s,388,316
O,1,132082,61,",",145,84
O,1,132227,82, ,175,93
O,1,132402,60,o,92,32
O,1,132494,72,r,103,31
O,1,132597,88, ,129,41
O,1,132726,48,r,218,170
O,1,132944,70,a,85,15
O,1,133029,59,t,171,112
O,1,133200,70,h,97,27
O,1,133297,72,e,184,112
O,1,133481,64,r,187,123
O,1,133668,72, ,455,383
O,1,134123,64,h,139,75
O,1,134262,77,a,231,154
O,1,134493,56,d,133,77
O,1,134626,60,",",156,96
O,1,134782,76, ,542,466
O,1,135324,68,a,533,465
O,1,135857,74, ,193,119
O,1,136050,74,p,118,44
O,1,136168,54,r,109,55
O,1,136277,56,o,214,158
O,1,136491,62,b,188,126
O,1,136679,76,l,157,81
O,1,136836,65,e,112,47
O,1,136948,60,m,164,104
O,1,137112,77, ,1703,1626
O,1,138815,52,",",157,105
O,1,138972,85, ,97,12
O,1,139069,68,w,153,85
O,1,139222,68,h,140,72
O,1,139362,68,i,81,13
O,1,139443,73,c,149,76
O,1,139592,52,h,178,126
O,1,139770,88, ,158,70
O,1,139928,80,w,236,156
O,1,140164,62,a,204,142
O,1,140368,77,s,741,664
O,1,141109,82, ,317,235
O,1,141426,68,t,131,63
O,1,141557,64,h,146,82
O,1,141703,78,i,136,58
O,1,141839,61,s,690,629
O,1,142529,73,:,457,384
O,1,142986,68, ,451,383
O,1,143437,84,m,187,103
O,1,143624,60,o,197,137
O,1,143821,72,s,155,83
O,1,143976,49,t,224,175
O,1,144200,93, ,223,130
O,1,144423,61,o,119,58
O,1,144542,75,f,120,45
O,1,144662,68, ,128,60
O,1,144790,54,t,61,7
O,1,144851,71,h,151,80
O,1,145002,49,e,104,55
O,1,145106,62, ,289,227
O,1,145395,65,p,120,55
O,1,145515,69,e,83,14
O,1,145598,49,o,166,117
O,1,145764,93,p,173,80
O,1,145937,53,l,141,88
O,1,146078,58,e,96,38
O,1,146174,82, ,177,95
O,1,146351,70,o,194,124
O,1,146545,52,n,170,118
O,1,146715,77, ,271,194
O,1,146986,76,i,223,147
O,1,147209,70,t,213,143
O,1,147422,56, ,276,220
O,1,147698,97,w,256,159
O,1,147954,71,e,207,136
O,1,148161,57,r,200,143
O,1,148361,52,e,172,120
O,1,148533,21, ,645,624
O,1,149178,72,u,197,125
O,1,149375,64,n,151,87
O,1,149526,65,h,96,31
O,1,149622,54,a,145,91
O,1,149767,67,p,147,80
O,1,149914,80,p,125,45
O,1,150039,61,y,231,170
O,1,150270,56, ,3260,3204
O,1,153530,95,f,95,0
O,1,153625,81,o,111,30
O,1,153736,83,r,110,27
O,1,153846,77, ,216,139
O,1,154062,70,p,84,14
O,1,154146,61,r,178,117
O,1,154324,56,e,88,32
O,1,154412,64,t,139,75
O,1,154551,60,t,163,103
O,1,154714,72,y,222,150
O,1,154936,70, ,380,310
O,1,155316,84,m,251,167
O,1,155567,71,u,138,67
O,1,155705,61,c,73,12
O,1,155778,57,h,209,152
O,1,155987,82, ,948,866
O,1,156935,99,o,137,38
O,1,157072,84,f,120,36
O,1,157192,100, ,129,29
O,1,157321,67,t,97,30
O,1,157418,77,h,132,55
O,1,157550,77,e,95,18
O,1,157645,70, ,267,197
O,1,157912,81,t,1091,1010
O,1,159003,75,i,191,116
O,1,159194,59,m,128,69
O,1,159322,60,e,297,237
O,1,159619,69,.,320,251
O,1,159939,61, ,2237,2176
O,1,162176,78,M,228,150
O,1,162404,64,a,12,-52
O,1,162416,88,n,186,98
O,1,162602,68,y,159,91
O,1,162761,84, ,149,65
O,1,162910,62,s,91,29
O,1,163001,71,o,171,100
O,1,163172,72,l,181,109
O,1,163353,53,u,94,41
O,1,163447,74,t,143,69
O,1,163590,60,i,147,87
O,1,163737,76,o,159,83
O,1,163896,71,n,136,65
O,1,164032,64,s,66,2
O,1,164098,64, ,199,135
O,1,164297,104,w,226,122
O,1,164523,68,w,1123,1055
O,1,165646,60,e,183,123
O,1,165829,58,r,163,105
O,1,165992,56,e,96,40
O,1,166088,93, ,127,34
O,1,166215,56,s,80,24
O,1,166295,63,u,167,104
O,1,166462,58,g,119,61
O,1,166581,72,g,104,32
O,1,166685,56,e,189,133
O,1,166874,68,s,80,12
O,1,166954,66,t,134,68
O,1,167088,48,e,196,148
O,1,167284,68,d,179,111
O,1,167463,72, ,1084,1012
O,1,168547,42,f,168,126
O,1,168715,90,o,177,87
O,1,168892,67,r,64,-3
O,1,168956,80, ,147,67
O,1,169103,32,t,101,69
O,1,169204,60,h,114,54
O,1,169318,60,i,88,28
O,1,169406,56,s,107,51
O,1,169513,76, ,239,163
O,1,169752,64,p,170,106
O,1,169922,76,o,86,10
O,1,170008,62,r,238,176
O,1,170246,52,b,179,127
O,1,170425,64,l,134,70
O,1,170559,70,e,102,32
O,1,170661,60,m,1591,1531
O,1,172252,52,r,96,44
O,1,172348,74,o,204,130
O,1,172552,61,b,191,130
O,1,172743,69,l,144,75
O,1,172887,63,e,56,-7
O,1,172943,48,m,183,135
O,1,173126,60,",",152,92
O,1,173278,92, ,300,208
O,1,173578,77,b,144,67
O,1,173722,73,u,134,61
O,1,173856,53,t,74,21
O,1,173930,80, ,2550,2470
O,1,176480,66,m,126,60
O,1,176606,64,o,151,87
O,1,176757,72,s,135,63
O,1,176892,52,t,164,112
O,1,177056,91, ,210,119
O,1,177266,52,o,88,36
O,1,177354,77,f,97,20
O,1,177451,81, ,137,56
O,1,177588,45,t,41,-4
O,1,177629,69,h,179,110
O,1,177808,52,e,184,132
O,1,177992,86,s,177,91
O,1,178169,50,e,121,71
O,1,178290,72, ,114,42
O,1,178404,80,w,182,102
O,1,178586,73,e,182,109
O,1,178768,65,r,188,123
O,1,178956,56,e,119,63
O,1,179075,75, ,360,285
O,1,179435,81,l,112,31
O,1,179547,81,a,234,153
O,1,179781,49,r,144,95
O,1,179925,61,g,74,13
O,1,179999,73,e,185,112
O,1,180184,70,l,88,18
O,1,180272,57,y,131,74
O,1,180403,72, ,283,211
O,1,180686,62,c,62,0
O,1,180748,72,o,165,93
O,1,180913,52,n,24,-28
O,1,180937,103,c,179,76
O,1,181116,108,e,158,50
O,1,181274,69,r,102,33
O,1,181376,70,n,106,36
O,1,181482,70,e,202,132
O,1,181684,80,d,125,45
O,1,181809,81, ,81,0
O,1,181890,80,w,160,80
O,1,182050,71,i,63,-8
O,1,182113,79,t,169,90
O,1,182282,58,h,224,166
O,1,182506,64, ,1213,1149
O,1,183719,54,t,125,71
O,1,183844,66,h,100,34
O,1,183944,65,e,116,51
O,1,184060,56, ,216,160
O,1,184276,72,m,150,78
O,1,184426,69,o,397,328
O,1,184823,69,v,180,111
O,1,185003,65,e,132,67
O,1,185135,57,m,118,61
O,1,185253,74,e,96,22
O,1,185349,63,n,236,173
O,1,185585,67,t,141,74
O,1,185726,51,s,90,39
O,1,185816,96, ,226,130
O,1,186042,72,o,92,20
O,1,186134,52,f,126,74
O,1,186260,60, ,139,79
O,1,186399,60,s,110,50
O,1,186509,73,m,121,48
O,1,186630,32,a,161,129
O,1,186791,66,l,197,131
O,1,186988,64,l,345,281
O,1,187333,66, ,275,209
O,1,187608,75,g,186,111
O,1,187794,60,r,75,15
O,1,187869,79,e,195,116
O,1,188064,70,e,168,98
O,1,188232,66,n,407,341
O,1,188639,44, ,951,907
O,1,189590,69,p,198,129
O,1,189788,80,i,138,58
O,1,189926,64,e,221,157
O,1,190147,55,c,193,138
O,1,190340,65,e,186,121
O,1,190526,84,s,121,37
O,1,190647,75, ,171,96
O,1,190818,60,o,88,28
O,1,190906,65,f,153,88
O,1,191059,63, ,202,139
O,1,191261,68,p,112,44
O,1,191373,58,a,66,8
O,1,191439,74,p,206,132
O,1,191645,44,e,215,171
O,1,191860,56,r,834,778
O,1,192694,62,",",164,102
O,1,192858,72, ,80,8
O,1,192938,71,w,153,82
O,1,193091,70,h,133,63
O,1,193224,72,i,72,0
O,1,193296,60,c,118,58
O,1,193414,52,h,197,145
O,1,193611,76, ,167,91
O,1,193778,60,i,117,57
O,1,193895,60,s,102,42
O,1,193997,65, ,192,127
O,1,194189,73,o,791,718
O,1,194980,61,f,546,485
O,1,195526,64,d,147,83
O,1,195673,54,d,233,179
O,1,195906,84, ,178,94
O,1,196084,83,b,109,26
O,1,196193,60,e,125,65
O,1,196318,56,c,118,62
O,1,196436,60,a,86,26
O,1,196522,80,u,119,39
O,1,196641,83,s,197,114
O,1,196838,55,e,107,52
O,1,196945,77, ,1524,1447
O,1,198469,84,o,194,110
O,1,198663,60,n,150,90
O,1,198813,76, ,80,4
O,1,198893,56,t,85,29
O,1,198978,64,h,129,65
O,1,199107,40,e,38,-2
O,1,199145,66, ,194,128
O,1,199339,64,w,125,61
O,1,199464,65,h,227,162
O,1,199691,54,o,172,118
O,1,199863,60,l,139,79
O,1,200002,64,e,1399,1335
O,1,201401,86, ,270,184
O,1,201671,70,i,109,39
O,1,201780,68,t,114,46
O,1,201894,72, ,328,256
O,1,202222,64,w,204,140
O,1,202426,50,a,145,95
O,1,202571,78,s,74,-4
O,1,202645,64,n,260,196
O,1,202905,68,',132,64
O,1,203037,72,t,135,63
O,1,203172,84, ,148,64
O,1,203320,60,t,111,51
O,1,203431,68,h,126,58
O,1,203557,72,e,100,28
O,1,203657,72, ,273,201
O,1,203930,62,s,146,84
O,1,204076,68,m,115,47
O,1,204191,56,a,129,73
O,1,204320,45,l,136,91
O,1,204456,64,l,244,180
O,1,204700,60, ,1113,1053
O,1,205813,73,g,218,145
O,1,206031,64,r,123,59
O,1,206154,68,e,178,110
O,1,206332,57,e,113,56
O,1,206445,62,n,195,133
O,1,206640,50, ,256,206
O,1,206896,69,p,217,148
O,1,207113,76,i,365,289
O,1,207478,66,e,176,110
O,1,207654,60,c,125,65
O,1,207779,60,e,207,147
O,1,207986,48,s,102,54
O,1,208088,67, ,191,124
O,1,208279,66,o,91,25
O,1,208370,52,f,115,63
O,1,208485,65, ,184,119
O,1,208669,58,p,113,55
O,1,208782,63,a,44,-19
O,1,208826,68,p,195,127
O,1,209021,70,e,168,98
O,1,209189,64,r,128,64
O,1,209317,78, ,195,117
O,1,209512,57,t,188,131
O,1,209700,82,h,91,9
O,1,209791,63,a,121,58
O,1,209912,65,t,182,117
O,1,210094,83, ,512,429
O,1,210606,88,w,219,131
O,1,210825,57,e,218,161
O,1,211043,21,r,167,146
O,1,211210,72,e,162,90
O,1,211372,88, ,366,278
O,1,211738,57,u,176,119
O,1,211914,69,n,183,114
O,1,212097,65,h,72,7
O,1,212169,49,a,192,143
O,1,212361,56,p,124,68
O,1,212485,73,p,101,28
O,1,212586,65,y,192,127
O,1,212778,72,.,206,134
O,1,212984,61, ,NA,NA
O,2,224,88,M,248,160
O,2,472,61,y,188,127
O,2,660,64, ,161,97
O,2,821,60,f,157,97
O,2,978,80,a,40,-40
O,2,1018,64,v,225,161
O,2,1243,65,o,131,66
O,2,1374,68,r,118,50
O,2,1492,64,i,201,137
O,2,1693,56,t,106,50
O,2,1799,64,e,108,44
O,2,1907,53, ,162,109
O,2,2069,52,m,121,69
O,2,2190,60,e,254,194
O,2,2444,68,a,124,56
O,2,2568,64,l,204,140
O,2,2772,68, ,196,128
O,2,2968,60,i,122,62
O,2,3090,73,s,109,36
O,2,3199,64, ,54212,54148
O,2,57411,102,s,224,122
O,2,57635,72,t,91,19
O,2,57726,76,e,238,162
O,2,57964,52,a,138,86
O,2,58102,48,k,250,202
O,2,58352,52,",",152,100
O,2,58504,64, ,125,61
O,2,58629,76,m,68,-8
O,2,58697,60,a,177,117
O,2,58874,68,s,72,4
O,2,58946,68,h,110,42
O,2,59056,68,e,179,111
O,2,59235,64,d,56,-8
O,2,59291,53, ,209,156
O,2,59500,60,p,144,84
O,2,59644,59,o,240,181
O,2,59884,54,t,143,89
O,2,60027,52,a,24,-28
O,2,60051,45,t,232,187
O,2,60283,69,o,111,42
O,2,60394,60,e,230,170
O,2,60624,56,s,277,221
O,2,60901,43,",",150,107
O,2,61051,56, ,56,0
O,2,61107,60,a,105,45
O,2,61212,60,n,97,37
O,2,61309,64,d,76,12
O,2,61385,63, ,139,76
O,2,61524,76,g,164,88
O,2,61688,64,r,88,24
O,2,61776,76,e,172,96
O,2,61948,44,e,61,17
O,2,62009,56,n,157,101
O,2,62166,68, ,146,78
O,2,62312,64,b,66,2
O,2,62378,60,e,203,143
O,2,62581,52,a,69,17
O,2,62650,58,n,105,47
O,2,62755,52,s,398,346
O,2,63153,68,.,165,97
O,2,63318,76, ,181,105
O,2,63499,62,I,148,86
O,2,63647,58, ,110,52
O,2,63757,68,a,72,4
O,2,63829,64,l,110,46
O,2,63939,76,s,60,-16
O,2,63999,60,o,149,89
O,2,64148,80, ,110,30
O,2,64258,66,r,169,103
O,2,64427,61,e,210,149
O,2,64637,60,a,60,0
O,2,64697,72,l,137,65
O,2,64834,72,l,118,46
O,2,64952,56,y,77,21
O,2,65029,64, ,173,109
O,2,65202,74,l,173,99
O,2,65375,58,i,133,75
O,2,65508,72,e,20,-52
O,2,65528,68,k,160,92
O,2,65688,70, ,54,-16
O,2,65742,80,t,133,53
O,2,65875,65,o,157,92
O,2,66032,76, ,658,582
O,2,66690,52,b,98,46
O,2,66788,80,a,92,12
O,2,66880,66,k,131,65
O,2,67011,52,e,98,46
O,2,67109,64,",",156,92
O,2,67265,82, ,94,12
O,2,67359,62,s,102,40
O,2,67461,48,o,141,93
O,2,67602,73, ,1556,1483
O,2,69158,66,I,213,147
O,2,69371,68, ,1907,1839
O,2,71278,92,l,182,90
O,2,71460,63,o,60,-3
O,2,71520,98,v,163,65
O,2,71683,94,e,131,37
O,2,71814,72, ,110,38
O,2,71924,72,e,214,142
O,2,72138,109,a,93,-16
O,2,72231,56,t,198,142
O,2,72429,68,i,147,79
O,2,72576,49,n,53,4
O,2,72629,53,g,115,62
O,2,72744,76, ,581,505
O,2,73325,77,d,157,80
O,2,73482,75,e,238,163
O,2,73720,64,s,122,58
O,2,73842,101,s,215,114
O,2,74057,72,e,183,111
O,2,74240,62,r,154,92
O,2,74394,51,t,84,33
O,2,74478,61,s,110,49
O,2,74588,77, ,363,286
O,2,74951,70,l,172,102
O,2,75123,61,i,170,109
O,2,75293,69,k,81,12
O,2,75374,56,e,83,27
O,2,75457,64, ,192,128
O,2,75649,68,p,201,133
O,2,75850,46,u,210,164
O,2,76060,20,m,168,148
O,2,76228,70,p,986,916
O,2,77214,71,k,170,99
O,2,77384,66,i,172,106
O,2,77556,50,n,155,105
O,2,77711,57, ,180,123
O,2,77891,68,p,168,100
O,2,78059,66,i,111,45
O,2,78170,76,e,86,10
O,2,78256,74, ,151,77
O,2,78407,55,a,31,-24
O,2,78438,61,n,152,91
O,2,78590,64,d,81,17
O,2,78671,80, ,2437,2357
O,2,81108,62,c,156,94
O,2,81264,72,o,149,77
O,2,81413,65,o,179,114
O,2,81592,65,k,158,93
O,2,81750,50,i,84,34
O,2,81834,62,e,180,118
O,2,82014,56,s,98,42
O,2,82112,56,.,NA,NA
P,1,184,71,F,302,231
P,1,486,104,a,275,171
P,1,761,109,r,128,19
P,1,889,188, ,195,7
P,1,1084,33,o,280,247
P,1,1364,129,u,519,390
P,1,1883,160,t,177,17
P,1,2060,188, ,208,20
P,1,2268,92,i,228,136
P,1,2496,131,n,116,-15
P,1,2612,171, ,148,-23
P,1,2760,99,t,96,-3
P,1,2856,149,h,149,0
P,1,3005,98,e,91,-7
P,1,3096,139, ,136,-3
P,1,3232,76,c,605,529
P,1,3837,117,u,230,113
P,1,4067,104,n,100,-4
P,1,4167,80,c,125,45
P,1,4292,136,h,195,59
P,1,4487,100,a,631,531
P,1,5118,128,r,381,253
P,1,5499,129,t,514,385
P,1,6013,112,e,302,190
P,1,6315,113,d,303,190
P,1,6618,184, ,1021,837
P,1,7639,140,b,148,8
P,1,7787,64,a,245,181
P,1,8032,60,c,77,17
P,1,8109,144,k,186,42
P,1,8295,68,w,221,153
P,1,8516,60,a,3272,3212
P,1,11788,184,t,331,147
P,1,12119,108,e,302,194
P,1,12421,132,r,672,540
P,1,13093,172,s,226,54
P,1,13319,216, ,391,175
P,1,13710,180,o,136,-44
P,1,13846,83,f,67,-16
P,1,13913,153, ,172,19
P,1,14085,76,t,60,-16
P,1,14145,124,h,162,38
P,1,14307,91,e,69,-22
P,1,14376,119, ,47,-72
P,1,14423,96,u,217,121
P,1,14640,119,n,108,-11
P,1,14748,100,f,282,182
P,1,15030,65,a,202,137
P,1,15232,88,d,16,-72
P,1,15248,52,s,112,60
P,1,15360,69,h,931,862
P,1,16291,127,s,112,-15
P,1,16403,80,h,227,147
P,1,16630,132,i,270,138
P,1,16900,109,o,242,133
P,1,17142,104,n,148,44
P,1,17290,136,a,132,-4
P,1,17422,84,b,246,162
P,1,17668,140,l,486,346
P,1,18154,100,e,50155,50055
P,1,68309,158, ,259,101
P,1,68568,148,e,223,75
P,1,68791,128,n,80,-48
P,1,68871,181,d,184,3
P,1,69055,132, ,96,-36
P,1,69151,152,o,80,-72
P,1,69231,100,f,92,-8
P,1,69323,160, ,175,15
P,1,69498,85,t,114,29
P,1,69612,124,h,207,83
P,1,69819,136,e,132,-4
P,1,69951,88, ,147,59
P,1,70098,100,w,189,89
P,1,70287,65,e,159,94
P,1,70446,92,s,234,142
P,1,70680,69,t,196,127
P,1,70876,64,e,166,102
P,1,71042,87,r,122,35
P,1,71164,104,n,133,29
P,1,71297,129, ,291,162
P,1,71588,96,s,51,-45
P,1,71639,88,p,209,121
P,1,71848,124,i,76,-48
P,1,71924,76,r,270,194
P,1,72194,64,a,79,15
P,1,72273,124,l,116,-8
P,1,72389,109, ,135,26
P,1,72524,72,a,216,144
P,1,72740,125,r,168,43
P,1,72908,80,m,175,95
P,1,73083,96, ,130,34
P,1,73213,141,o,197,56
P,1,73410,121, ,599,478
P,1,74009,100,f,101,1
P,1,74110,259, ,255,-4
P,1,74365,113,t,140,27
P,1,74505,76,h,96,20
P,1,74601,92,e,76,-16
P,1,74677,92, ,228,136
P,1,74905,77,G,298,221
P,1,75203,59,a,94,35
P,1,75297,150,l,108,-42
P,1,75405,41,a,181,140
P,1,75586,57,z,200,143
P,1,75786,136,y,223,87
P,1,76009,141, ,1187,1046
P,1,77196,125,c,522,397
P,1,77718,120,x,231,111
P,1,77949,129,y,183,54
P,1,78132,205, ,343,138
P,1,78475,140,l,244,104
P,1,78719,152,i,124,-28
P,1,78843,84,e,325,241
P,1,79168,81,s,194,113
P,1,79362,116, ,486,370
P,1,79848,69,a,183,114
P,1,80031,128, ,104,-24
P,1,80135,92,s,136,44
P,1,80271,80,m,92,12
P,1,80363,108,a,123,15
P,1,80486,76,l,142,66
P,1,80628,117,l,204,87
P,1,80832,112, ,178,66
P,1,81010,125,u,240,115
P,1,81250,161,n,610,449
P,1,81860,84,r,185,101
P,1,82045,120,e,159,39
P,1,82204,120,g,131,11
P,1,82335,49,a,211,162
P,1,82546,69,r,171,102
P,1,82717,104,d,222,118
P,1,82939,81,e,181,100
P,1,83120,92,d,171,79
P,1,83291,124, ,1926,1802
P,1,85217,100,y,136,36
P,1,85353,96,e,535,439
P,1,85888,73,l,151,78
P,1,86039,72,l,190,118
P,1,86229,109,o,156,47
P,1,86385,92,w,113,21
P,1,86498,108, ,164,56
P,1,86662,108,s,109,1
P,1,86771,84,u,203,119
P,1,86974,84,n,385,301
P,1,87359,69,.,3326,3257
P,1,90685,124,O,230,106
P,1,90915,124,r,195,71
P,1,91110,104,b,256,152
P,1,91366,120,i,170,50
P,1,91536,116,t,76,-40
P,1,91612,108,i,202,94
P,1,91814,120,n,84,-36
P,1,91898,100,g,122,22
P,1,92020,100, ,450,350
P,1,92470,100,t,75,-25
P,1,92545,88,h,266,178
P,1,92811,89,o,16,-73
P,1,92827,96,i,104,8
P,1,92931,69,s,1262,1193
P,1,94193,144,i,140,-4
P,1,94333,137,s,159,22
P,1,94492,124, ,186,62
P,1,94678,96,a,244,148
P,1,94922,84,t,119,35
P,1,95041,116, ,213,97
P,1,95254,73,a,98,25
P,1,95352,56, ,124,68
P,1,95476,85,d,137,52
P,1,95613,136,i,80,-56
P,1,95693,64,s,203,139
P,1,95896,80,t,316,236
P,1,96212,88,a,158,70
P,1,96370,131,n,104,-27
P,1,96474,52,c,184,132
P,1,96658,76,e,80,4
P,1,96738,128, ,151,23
P,1,96889,91,r,19,-72
P,1,96908,100,o,215,115
P,1,97123,103,u,114,11
P,1,97237,102,g,116,14
P,1,97353,101,h,301,200
P,1,97654,172,l,173,1
P,1,97827,107,y,243,136
P,1,98070,141, ,737,596
P,1,98807,120, ,566,446
P,1,99373,96,n,209,113
P,1,99582,84,i,180,96
P,1,99762,88,n,96,8
P,1,99858,92,e,418,326
P,1,100276,116,t,248,132
P,1,100524,100,y,759,659
P,1,101283,140,t,369,229
P,1,101652,108,w,158,50
P,1,101810,144,o,263,119
P,1,102073,112, ,167,55
P,1,102240,104,m,230,126
P,1,102470,81,i,213,132
P,1,102683,68,l,121,53
P,1,102804,100,l,341,241
P,1,103145,88,i,209,121
P,1,103354,88,o,240,152
P,1,103594,88,n,291,203
P,1,103885,116, ,400,284
P,1,104285,88,m,225,137
P,1,104510,84,i,225,141
P,1,104735,113,l,48,-65
P,1,104783,64,e,209,145
P,1,104992,51,s,138,87
P,1,105130,128, ,105,-23
P,1,105235,134,i,123,-11
P,1,105358,72,s,94,22
P,1,105452,72, ,164,92
P,1,105616,88,a,118,30
P,1,105734,112,n,40,-72
P,1,105774,140, ,267,127
P,1,106041,112,u,153,41
P,1,106194,64,t,134,70
P,1,106328,72,t,209,137
P,1,106537,76,e,144,68
P,1,106681,88,r,425,337
P,1,107106,133,l,205,72
P,1,107311,105,y,186,81
P,1,107497,132, ,121,-11
P,1,107618,68,i,171,103
P,1,107789,92,n,52,-40
P,1,107841,116,s,179,63
P,1,108020,111,i,108,-3
P,1,108128,96,g,139,43
P,1,108267,80,n,203,123
P,1,108470,124,i,171,47
P,1,108641,108,f,131,23
P,1,108772,124,i,234,110
P,1,109006,36,c,219,183
P,1,109225,52,a,330,278
P,1,109555,125,n,206,81
P,1,109761,96,t,434,338
P,1,110195,103, ,92,-11
P,1,110287,52,l,187,135
P,1,110474,75,i,60,-15
P,1,110534,56,t,149,93
P,1,110683,76,t,103,27
P,1,110786,133,l,132,-1
P,1,110918,84,e,88,4
P,1,111006,127, ,124,-3
P,1,111130,108,b,276,168
P,1,111406,96,l,309,213
P,1,111715,80,u,96,16
P,1,111811,112,e,109,-3
P,1,111920,116, ,141,25
P,1,112061,121,g,165,44
P,1,112226,72,r,200,128
P,1,112426,64,e,157,93
P,1,112583,73,e,204,131
P,1,112787,96,n,181,85
P,1,112968,144, ,412,268
P,1,113380,144,p,260,116
P,1,113640,112,l,146,34
P,1,113786,80,a,142,62
P,1,113928,117,n,261,144
P,1,114189,144,t,956,812
P,1,115145,132, ,158,26
P,1,115303,127,w,108,-19
P,1,115411,88,h,230,142
P,1,115641,135,o,84,-51
P,1,115725,72,s,195,123
P,1,115920,95,e,84,-11
P,1,116004,140, ,303,163
P,1,116307,108,a,589,481
P,1,116896,168,p,185,17
P,1,117081,136,e,641,505
P,1,117722,116,d,215,99
P,1,117937,77,e,197,120
P,1,118134,56,s,174,118
P,1,118308,76,c,306,230
P,1,118614,152,n,518,366
P,1,119132,104,e,136,32
P,1,119268,120,n,632,512
P,1,119900,100,d,206,106
P,1,120106,52,e,162,110
P,1,120268,72,d,120,48
P,1,120388,116, ,260,144
P,1,120648,100,l,225,125
P,1,120873,135,i,88,-47
P,1,120961,64,f,238,174
P,1,121199,88,e,114,26
P,1,121313,128, ,457,329
P,1,121770,68,f,135,67
P,1,121905,168,o,296,128
P,1,122201,96,r,149,53
P,1,122350,147,m,159,12
P,1,122509,81,s,159,78
P,1,122668,152, ,152,0
P,1,122820,69,a,212,143
P,1,123032,76,r,150,74
P,1,123182,76,e,95,19
P,1,123277,92, ,141,49
P,1,123418,112,s,119,7
P,1,123537,133,o,61,-72
P,1,123598,132, ,370,238
P,1,123968,88,a,104,16
P,1,124072,140,m,121,-19
P,1,124193,64,a,222,158
P,1,124415,31,z,83,52
P,1,124498,80,i,202,122
P,1,124700,100,n,111,11
P,1,124811,89,g,131,42
P,1,124942,124,l,232,108
P,1,125174,64,u,176,112
P,1,125350,140, ,151,11
P,1,125501,101,p,134,33
P,1,125635,72,t,103,31
P,1,125738,68,i,187,119
P,1,125925,72,m,178,106
P,1,126103,100,i,124,24
P,1,126227,76,y,1597,1521
P,1,127824,48,u,576,528
P,1,128400,72,y,149,77
P,1,128549,104, ,327,223
P,1,128876,108,p,111,3
P,1,128987,97,r,113,16
P,1,129100,56,i,195,139
P,1,129295,52,m,166,114
P,1,129461,92,i,93,1
P,1,129554,88,t,400,312
P,1,129954,128,i,153,25
P,1,130107,76,c,218,142
P,1,130325,91,e,84,-7
P,1,130409,136, ,1010,874
P,1,131419,104,v,576,472
P,1,131995,116,i,72,-44
P,1,132067,84,v,216,132
P,1,132283,84,e,100,16
P,1,132383,133, ,157,24
P,1,132540,68,t,116,48
P,1,132656,124,h,194,70
P,1,132850,36,a,777,741
P,1,133627,80,a,600,520
P,1,134227,109,t,194,85
P,1,134421,112, ,304,192
P,1,134725,117,t,120,3
P,1,134845,97,h,167,70
P,1,135012,132,e,202,70
P,1,135214,124,y,194,70
P,1,135408,124, ,198,74
P,1,135606,76,s,210,134
P,1,135816,99,t,92,-7
P,1,135908,84,i,235,151
P,1,136143,60,l,116,56
P,1,136259,100,l,103,3
P,1,136362,89, ,121,32
P,1,136483,121,t,88,-33
P,1,136571,84,h,198,114
P,1,136769,89,i,198,109
P,1,136967,80,n,192,112
P,1,137159,123,k,112,-11
P,1,137271,113, ,112,-1
P,1,137383,96,f,107,11
P,1,137490,89,i,265,176
P,1,137755,104,i,107,3
P,1,137862,97,g,153,56
P,1,138015,96,i,124,28
P,1,138139,60,y,1308,1248
P,1,139447,101,d,128,27
P,1,139575,117,i,167,50
P,1,139742,96,g,99,3
P,1,139841,157,i,168,11
P,1,140009,81,t,344,263
P,1,140353,100,a,138,38
P,1,140491,155,l,140,-15
P,1,140631,108, ,364,256
P,1,140995,72,w,191,119
P,1,141186,60,a,242,182
P,1,141428,48,t,225,177
P,1,141653,60,c,170,110
P,1,141823,128,h,76,-52
P,1,141899,59,e,188,129
P,1,142087,76,s,119,43
P,1,142206,124, ,202,78
P,1,142408,128,a,365,237
P,1,142773,80,r,186,106
P,1,142959,91,e,80,-11
P,1,143039,108, ,196,88
P,1,143235,103,a,96,-7
P,1,143331,92, ,126,34
P,1,143457,136,p,72,-64
P,1,143529,65,r,161,96
P,1,143690,60,e,198,138
P,1,143888,68,t,132,64
P,1,144020,88,t,190,102
P,1,144210,84,y,205,121
P,1,144415,96, ,215,119
P,1,144630,115,n,88,-27
P,1,144718,80,e,234,154
P,1,144952,52,a,246,194
P,1,145198,64,t,157,93
P,1,145355,48, ,144,96
P,1,145499,68, ,216,148
P,1,145715,107,i,64,-43
P,1,145779,64,d,882,818
P,1,146661,72, ,593,521
P,1,147254,104, ,199,95
P,1,147453,100, ,201,101
P,1,147654,140,i,169,29
P,1,147823,56,d,174,118
P,1,147997,56,e,228,172
P,1,148225,44,a,763,719
P,1,148988,104,.,1601,1497
P,1,150589,104,T,236,132
P,1,150825,92,h,237,145
P,1,151062,127,i,116,-11
P,1,151178,128,s,131,3
P,1,151309,136, ,133,-3
P,1,151442,100,p,211,111
P,1,151653,88,l,143,55
P,1,151796,88,a,140,52
P,1,151936,128,n,751,623
P,1,152687,60,e,197,137
P,1,152884,81,t,115,34
P,1,152999,133, ,705,572
P,1,153704,120, ,219,99
P,1,153923,104,h,144,40
P,1,154067,76,a,184,108
P,1,154251,88,s,238,150
P,1,154489,84,e,1297,1213
P,1,155786,164,",",239,75
P,1,156025,164, ,181,17
P,1,156206,156,o,153,-3
P,1,156359,120,r,121,1
P,1,156480,140, ,591,451
P,1,157071,65,r,100,35
P,1,157171,57,r,261,204
P,1,157432,47,a,704,657
P,1,158136,76,a,250,174
P,1,158386,76,t,130,54
P,1,158516,113,h,129,16
P,1,158645,49,e,166,117
P,1,158811,88,r,121,33
P,1,158932,132, ,692,560
P,1,159624,80, ,174,94
P,1,159798,76, ,145,69
P,1,159943,131,h,104,-27
P,1,160047,68,a,254,186
P,1,160301,71,d,19,-52
P,1,160320,40,s,963,923
P,1,161283,148,",",183,35
P,1,161466,137, ,286,149
P,1,161752,112,a,160,48
P,1,161912,128, ,200,72
P,1,162112,120,p,163,43
P,1,162275,120,r,120,0
P,1,162395,136,o,242,106
P,1,162637,97,g,2390,2293
P,1,165027,124, ,135,11
P,1,165162,89,p,124,35
P,1,165286,103,r,100,-3
P,1,165386,132,o,191,59
P,1,165577,40,g,533,493
P,1,166110,101,b,126,25
P,1,166236,120,l,205,85
P,1,166441,113,e,97,-16
P,1,166538,104,m,3643,3539
P,1,170181,143, ,309,166
P,1,170490,120,w,116,-4
P,1,170606,44,h,177,133
P,1,170783,108,i,1035,927
P,1,171818,132,",",193,61
P,1,172011,96, ,169,73
P,1,172180,112,w,92,-20
P,1,172272,65,h,201,136
P,1,172473,89,i,134,45
P,1,172607,120,c,104,-16
P,1,172711,100,h,112,12
P,1,172823,113, ,199,86
P,1,173022,68,w,219,151
P,1,173241,48,a,156,108
P,1,173397,109,s,129,20
P,1,173526,141, ,504,363
P,1,174030,64, ,318,254
P,1,174348,99,t,76,-23
P,1,174424,76,h,213,137
P,1,174637,121,i,138,17
P,1,174775,69,s,454,385
P,1,175229,152,:,781,629
P,1,176010,160, ,240,80
P,1,176250,149,m,293,144
P,1,176543,128,o,85,-43
P,1,176628,59,s,208,149
P,1,176836,100,r,698,598
P,1,177534,104,t,81,-23
P,1,177615,131, ,139,8
P,1,177754,149,o,89,-60
P,1,177843,99,f,75,-24
P,1,177918,137, ,173,36
P,1,178091,76,t,52,-24
P,1,178143,101,h,143,42
P,1,178286,133,e,93,-40
P,1,178379,123, ,131,8
P,1,178510,109,p,217,108
P,1,178727,101,o,361,260
P,1,179088,132,e,151,19
P,1,179239,93,o,196,103
P,1,179435,97,p,2858,2761
P,1,182293,99,e,100,1
P,1,182393,84,o,199,115
P,1,182592,77,p,186,109
P,1,182778,109,l,162,53
P,1,182940,120,e,121,1
P,1,183061,135, ,115,-20
P,1,183176,65,o,251,186
P,1,183427,120,n,312,192
P,1,183739,109, ,129,20
P,1,183868,125,i,279,154
P,1,184147,132,t,185,53
P,1,184332,113, ,233,120
P,1,184565,65,w,182,117
P,1,184747,72,e,176,104
P,1,184923,60,r,160,100
P,1,185083,85,e,110,25
P,1,185193,128, ,105,-23
P,1,185298,99,u,206,107
P,1,185504,77,n,210,133
P,1,185714,116,h,231,115
P,1,185945,101,a,141,40
P,1,186086,85,p,163,78
P,1,186249,136,p,81,-55
P,1,186330,100,y,121,21
P,1,186451,185, ,199,14
P,1,186650,108,f,101,-7
P,1,186751,124,o,124,0
P,1,186875,75,r,59,-16
P,1,186934,121, ,336,215
P,1,187270,116,p,97,-19
P,1,187367,59,r,171,112
P,1,187538,49,e,173,124
P,1,187711,78,t,144,66
P,1,187855,89,t,191,102
P,1,188046,77,y,152,75
P,1,188198,89, ,171,82
P,1,188369,109,m,222,113
P,1,188591,105,u,112,7
P,1,188703,120,c,117,-3
P,1,188820,99,h,112,13
P,1,188932,135, ,143,8
P,1,189075,140,o,105,-35
P,1,189180,103,f,115,12
P,1,189295,145, ,175,30
P,1,189470,92,t,88,-4
P,1,189558,100,h,142,42
P,1,189700,100,e,104,4
P,1,189804,229, ,447,218
P,1,190251,89, ,279,190
P,1,190530,81,t,88,7
P,1,190618,89,i,201,112
P,1,190819,100,m,111,11
P,1,190930,117,e,468,351
P,1,191398,152,.,155,3
P,1,191553,125, ,233,108
P,1,191786,109,m,693,584
P,1,192479,108,M,166,58
P,1,192645,77,a,110,33
P,1,192755,57,n,216,159
P,1,192971,108,y,212,104
P,1,193183,129, ,193,64
P,1,193376,117,s,326,209
P,1,193702,97,o,183,86
P,1,193885,77,l,201,124
P,1,194086,100,u,246,146
P,1,194332,79,t,76,-3
P,1,194408,75,i,195,120
P,1,194603,97,o,292,195
P,1,194895,121,n,187,66
P,1,195082,125,s,193,68
P,1,195275,140, ,380,240
P,1,195655,73,s,375,302
P,1,196030,88,w,179,91
P,1,196209,73,e,176,103
P,1,196385,57,r,167,110
P,1,196552,73,e,97,24
P,1,196649,101, ,146,45
P,1,196795,109,w,675,566
P,1,197470,61,s,138,77
P,1,197608,81,u,223,142
P,1,197831,73,g,282,209
P,1,198113,96,g,99,3
P,1,198212,65,e,185,120
P,1,198397,77,s,226,149
P,1,198623,61,t,177,116
P,1,198800,85,e,186,101
P,1,198986,89,d,92,3
P,1,199078,64, ,432,368
P,1,199510,72,f,106,34
P,1,199616,136,o,116,-20
P,1,199732,89,r,109,20
P,1,199841,149, ,160,11
P,1,200001,92,t,76,-16
P,1,200077,80,h,217,137
P,1,200294,113,i,124,11
P,1,200418,109,s,109,0
P,1,200527,139, ,108,-31
P,1,200635,115,p,116,1
P,1,200751,68,r,126,58
P,1,200877,112,o,101,-11
P,1,200978,84,b,144,60
P,1,201122,117,l,153,36
P,1,201275,101,e,126,25
P,1,201401,109,m,1239,1130
P,1,202640,120,",",230,110
P,1,202870,108, ,672,564
P,1,203542,92,b,234,142
P,1,203776,108,u,100,-8
P,1,203876,101,t,122,21
P,1,203998,128, ,69,-59
P,1,204067,107,m,226,119
P,1,204293,141,o,52,-89
P,1,204345,89,s,229,140
P,1,204574,108,t,93,-15
P,1,204667,151, ,116,-35
P,1,204783,147,o,115,-32
P,1,204898,79,f,76,-3
P,1,204974,116, ,147,31
P,1,205121,85,t,84,-1
P,1,205205,121,h,147,26
P,1,205352,85,e,191,106
P,1,205543,60,s,161,101
P,1,205704,96,e,92,-4
P,1,205796,172, ,153,-19
P,1,205949,88,w,202,114
P,1,206151,69,e,168,99
P,1,206319,69,r,164,95
P,1,206483,101,e,175,74
P,1,206658,141, ,198,57
P,1,206856,152,l,125,-27
P,1,206981,76,a,211,135
P,1,207192,73,r,88,15
P,1,207280,97,g,112,15
P,1,207392,69,e,179,110
P,1,207571,144,l,92,-52
P,1,207663,89,y,223,134
P,1,207886,109, ,746,637
P,1,208632,96,c,76,-20
P,1,208708,85,o,215,130
P,1,208923,100,n,68,-32
P,1,208991,68,c,195,127
P,1,209186,93,e,116,23
P,1,209302,128,n,65,-63
P,1,209367,67,r,178,111
P,1,209545,61,e,134,73
P,1,209679,100,d,112,12
P,1,209791,93, ,2687,2594
P,1,212478,113,r,139,26
P,1,212617,120,n,108,-12
P,1,212725,77,e,166,89
P,1,212891,89,d,96,7
P,1,212987,76, ,215,139
P,1,213202,110,w,109,-1
P,1,213311,124,i,208,84
P,1,213519,96,t,165,69
P,1,213684,140,h,293,153
P,1,213977,140, ,408,268
P,1,214385,88,m,205,117
P,1,214590,128,o,194,66
P,1,214784,69,v,227,158
P,1,215011,89,e,143,54
P,1,215154,124,m,120,-4
P,1,215274,105,e,178,73
P,1,215452,105,n,121,16
P,1,215573,81,t,241,160
P,1,215814,105,s,140,35
P,1,215954,136, ,116,-20
P,1,216070,140,o,108,-32
P,1,216178,108,f,100,-8
P,1,216278,129, ,175,46
P,1,216453,109,s,109,0
P,1,216562,80,m,136,56
P,1,216698,112,a,109,-3
P,1,216807,59,l,146,87
P,1,216953,120,l,112,-8
P,1,217065,117, ,175,58
P,1,217240,109,g,246,137
P,1,217486,73,r,208,135
P,1,217694,73,e,188,115
P,1,217882,60,e,122,62
P,1,218004,56,e,126,70
P,1,218130,105,n,1202,1097
P,1,219332,93,n,303,210
P,1,219635,132,p,84,-48
P,1,219719,68, ,689,621
P,1,220408,114, ,72,-42
P,1,220480,80,p,219,139
P,1,220699,104,i,68,-36
P,1,220767,80,e,553,473
P,1,221320,79,c,343,264
P,1,221663,73,e,225,152
P,1,221888,56,s,173,117
P,1,222061,141, ,274,133
P,1,222335,149,p,702,553
P,1,223037,110,o,87,-23
P,1,223124,84,f,99,15
P,1,223223,129, ,1186,1057
P,1,224409,140, ,202,62
P,1,224611,133,p,216,83
P,1,224827,119,a,101,-18
P,1,224928,120,p,1490,1370
P,1,226418,63,e,183,120
P,1,226601,81,r,412,331
P,1,227013,201,",",319,118
P,1,227332,125, ,219,94
P,1,227551,104,w,88,-16
P,1,227639,81,h,203,122
P,1,227842,92,i,96,4
P,1,227938,140,c,128,-12
P,1,228066,73,h,36,-37
P,1,228102,140, ,174,34
P,1,228276,95,i,69,-26
P,1,228345,98,s,91,-7
P,1,228436,99, ,96,-3
P,1,228532,124,o,116,-8
P,1,228648,20,d,848,828
P,1,229496,96,d,100,4
P,1,229596,121, ,120,-1
P,1,229716,104,b,53,-51
P,1,229769,67,e,189,122
P,1,229958,69,c,822,753
P,1,230780,104,a,151,47
P,1,230931,103,u,99,-4
P,1,231030,57,s,162,105
P,1,231192,88,e,76,-12
P,1,231268,136, ,116,-20
P,1,231384,85,o,229,144
P,1,231613,104,n,72,-32
P,1,231685,132, ,132,0
P,1,231817,76,t,68,-8
P,1,231885,120,h,159,39
P,1,232044,103,e,92,-11
P,1,232136,108, ,194,86
P,1,232330,137,w,300,163
P,1,232630,113,h,286,173
P,1,232916,81,o,235,154
P,1,233151,112,l,124,12
P,1,233275,116,e,124,8
P,1,233399,169, ,197,28
P,1,233596,141,i,221,80
P,1,233817,116,t,104,-12
P,1,233921,117, ,236,119
P,1,234157,57,w,209,152
P,1,234366,44,a,159,115
P,1,234525,76,s,110,34
P,1,234635,68,n,270,202
P,1,234905,156,',167,11
P,1,235072,112,t,105,-7
P,1,235177,160, ,152,-8
P,1,235329,105,t,139,34
P,1,235468,129,h,152,23
P,1,235620,108,e,104,-4
P,1,235724,92, ,236,144
P,1,235960,77,s,343,266
P,1,236303,89,m,121,32
P,1,236424,93,a,122,29
P,1,236546,77,l,156,79
P,1,236702,133,l,134,1
P,1,236836,62, ,141,79
P,1,236977,81,g,214,133
P,1,237191,81,r,201,120
P,1,237392,60,e,149,89
P,1,237541,81,e,286,205
P,1,237827,121,n,236,115
P,1,238063,89, ,104,15
P,1,238167,112,p,123,11
P,1,238290,102,e,121,19
P,1,238411,129,i,163,34
P,1,238574,60,c,212,152
P,1,238786,48,e,167,119
P,1,238953,73,s,125,52
P,1,239078,93, ,115,22
P,1,239193,140,o,96,-44
P,1,239289,75,f,68,-7
P,1,239357,137, ,455,318
P,1,239812,125,p,136,11
P,1,239948,77,a,109,32
P,1,240057,125,p,194,69
P,1,240251,49,e,212,163
P,1,240463,29,r,300,271
P,1,240763,133, ,149,16
P,1,240912,85,t,65,-20
P,1,240977,80,h,211,131
P,1,241188,104,a,119,15
P,1,241307,97,t,128,31
P,1,241435,108, ,161,53
P,1,241596,41,w,209,168
P,1,241805,44,e,169,125
P,1,241974,64,r,167,103
P,1,242141,97,e,142,45
P,1,242283,109, ,192,83
P,1,242475,80, ,194,114
P,1,242669,101,u,796,695
P,1,243465,80, ,172,92
P,1,243637,81, ,97,16
P,1,243734,101,u,199,98
P,1,243933,120,n,247,127
P,1,244180,112,h,174,62
P,1,244354,76,a,154,78
P,1,244508,29,p,114,85
P,1,244622,105,p,148,43
P,1,244770,89,y,250,161
P,1,245020,109,.,NA,NA
P,2,208,115,M,99,-16
P,2,307,105,y,155,50
P,2,462,132, ,232,100
P,2,694,64,f,358,294
P,2,1052,33,a,403,370
P,2,1455,72,v,156,84
P,2,1611,172,o,308,136
P,2,1919,88,r,186,98
P,2,2105,132,i,139,7
P,2,2244,101,t,289,188
P,2,2533,100,e,111,11
P,2,2644,149, ,608,459
P,2,3252,92,f,146,54
P,2,3398,81,o,165,84
P,2,3563,124,o,72,-52
P,2,3635,115,d,88,-27
P,2,3723,160, ,6302,6142
P,2,10025,164,i,757,593
P,2,10782,152,s,204,52
P,2,10986,144, ,147,3
P,2,11133,129,p,262,133
P,2,11395,100,i,135,35
P,2,11530,64,z,165,101
P,2,11695,76,z,268,192
P,2,11963,56,a,187,131
P,2,12150,136, ,173,37
P,2,12323,135,b,96,-39
P,2,12419,68,e,201,133
P,2,12620,68,c,290,222
P,2,12910,103,a,111,8
P,2,13021,125,u,146,21
P,2,13167,51,s,180,129
P,2,13347,72,e,83,11
P,2,13430,125, ,140,15
P,2,13570,120,i,117,-3
P,2,13687,128,t,80,-48
P,2,13767,164, ,1614,1450
P,2,15381,164,i,188,24
P,2,15569,148,s,196,48
P,2,15765,144, ,309,165
P,2,16074,100,t,107,7
P,2,16181,129,h,146,17
P,2,16327,112,e,92,-20
P,2,16419,132, ,179,47
P,2,16598,169,h,245,76
P,2,16843,100,a,260,160
P,2,17103,48,r,176,128
P,2,17279,40,d,453,413
P,2,17732,76,e,211,135
P,2,17943,44,s,189,145
P,2,18132,72,t,84,12
P,2,18216,96, ,123,27
P,2,18339,72,t,126,54
P,2,18465,85,o,16,-69
P,2,18481,121, ,217,96
P,2,18698,77,m,56,-21
P,2,18754,84,e,212,128
P,2,18966,64,s,137,73
P,2,19103,72,s,136,64
P,2,19239,116, ,903,787
P,2,20142,100,u,493,393
P,2,20635,68,p,19647,19579
P,2,40282,173,h,10084,9911
P,2,50366,188,i,2311,2123
P,2,52677,125,i,183,58
P,2,52860,111,s,108,-3
P,2,52968,108, ,126,18
P,2,53094,133,h,109,-24
P,2,53203,88,a,223,135
P,2,53426,56,r,147,91
P,2,53573,80,d,81,1
P,2,53654,71, ,170,99
P,2,53824,95,t,79,-16
P,2,53903,117,o,57,-60
P,2,53960,165, ,201,36
P,2,54161,148,m,116,-32
P,2,54277,76,e,255,179
P,2,54532,40,s,130,90
P,2,54662,76,s,126,50
P,2,54788,135, ,120,-15
P,2,54908,80,u,250,170
P,2,55158,108,p,345,237
P,2,55503,96,.,937,841
P,2,56440,200, ,859,659
P,2,57299,105,A,126,21
P,2,57425,120,l,263,143
P,2,57688,64,m,315,251
P,2,58003,128,o,157,29
P,2,58160,85,s,288,203
P,2,58448,84,t,52,-32
P,2,58500,136, ,313,177
P,2,58813,92,a,119,27
P,2,58932,76,l,141,65
P,2,59073,125,l,152,27
P,2,59225,128, ,617,489
P,2,59842,116,p,235,119
P,2,60077,107,i,96,-11
P,2,60173,40,z,108,68
P,2,60281,112,z,334,222
P,2,60615,112,a,189,77
P,2,60804,164, ,472,308
P,2,61276,132,i,263,131
P,2,61539,96,s,99,3
P,2,61638,113, ,217,104
P,2,61855,80,g,81,1
P,2,61936,87,o,163,76
P,2,62099,107,o,88,-19
P,2,62187,99,d,71,-28
P,2,62258,129, ,221,92
P,2,62479,105,a,108,3
P,2,62587,97,n,144,47
P,2,62731,72,d,75,3
P,2,62806,112, ,138,26
P,2,62944,104,i,112,8
P,2,63056,68,s,75,7
P,2,63131,93, ,156,63
P,2,63287,144,h,167,23
P,2,63454,64,a,4211,4147
P,2,67665,140, ,1910,1770
P,2,69575,88,t,119,31
P,2,69694,112,h,207,95
P,2,69901,104,e,111,7
P,2,70012,97, ,215,118
P,2,70227,103,b,80,-23
P,2,70307,55,e,223,168
P,2,70530,56,s,235,179
P,2,70765,84,t,73,-11
P,2,70838,144, ,210,66
P,2,71048,167,i,175,8
P,2,71223,109,s,156,47
P,2,71379,148, ,1335,1187
P,2,72714,144,o,14449,14305
P,2,87163,156, ,16096,15940
P,2,103259,123,I,107,-16
P,2,103366,89,t,90,1
P,2,103456,78, ,66,-12
P,2,103522,121,i,155,34
P,2,103677,109,s,133,24
P,2,103810,124, ,178,54
P,2,103988,132,a,140,8
P,2,104128,153, ,194,41
P,2,104322,97,s,210,113
P,2,104532,53,a,204,151
P,2,104736,68,f,171,103
P,2,104907,77,e,80,3
P,2,104987,69, ,139,70
P,2,105126,92,t,73,-19
P,2,105199,59,h,176,117
P,2,105375,81,i,211,130
P,2,105586,73,n,158,85
P,2,105744,29,g,47,18
P,2,105791,112, ,2260,2148
P,2,108051,140,o,84,-56
P,2,108135,84,r,222,138
P,2,108357,57,d,167,110
P,2,108524,57,e,157,100
P,2,108681,65,r,65,0
P,2,108746,124, ,301,177
P,2,109047,53,a,268,215
P,2,109315,77,t,80,3
P,2,109395,116, ,104,-12
P,2,109499,64,m,178,114
P,2,109677,140,o,76,-64
P,2,109753,52,s,195,143
P,2,109948,88,t,80,-8
P,2,110028,124, ,153,29
P,2,110181,77,r,191,114
P,2,110372,65,e,409,344
P,2,110781,41,s,258,217
P,2,111039,64,t,548,484
P,2,111587,76,a,117,41
P,2,111704,109,u,150,41
P,2,111854,85,r,280,195
P,2,112134,89,a,105,16
P,2,112239,88,n,163,75
P,2,112402,89,t,263,174
P,2,112665,113,s,130,17
P,2,112795,145, ,3699,3554
P,2,116494,56,f,223,167
P,2,116717,128,o,124,-4
P,2,116841,72,r,76,4
P,2,116917,93, ,214,121
P,2,117131,103,a,115,12
P,2,117246,112, ,56,-56
P,2,117302,92,m,107,15
P,2,117409,81,e,249,168
P,2,117658,105,a,3844,3739
P,2,121502,120,",",127,7
P,2,121629,125, ,166,41
P,2,121795,92,e,2974,2882
P,2,124769,88,x,240,152
P,2,125009,80,c,249,169
P,2,125258,93,e,127,34
P,2,125385,133,p,186,53
P,2,125571,108,t,182,74
P,2,125753,164, ,1152,988
P,2,126905,112,t,117,5
P,2,127022,91,h,171,80
P,2,127193,85,e,100,15
P,2,127293,124,y,152,28
P,2,127445,137, ,144,7
P,2,127589,61,d,83,22
P,2,127672,140,o,88,-52
P,2,127760,100, ,233,133
P,2,127993,41,a,265,224
P,2,128258,72,t,56,-16
P,2,128314,113, ,244,131
P,2,128558,85,d,189,104
P,2,128747,97,h,218,121
P,2,128965,57,a,159,102
P,2,129124,72,l,184,112
P,2,129308,97,l,7028,6931
P,2,136336,71,d,117,46
P,2,136453,72,h,183,111
P,2,136636,57,a,123,66
P,2,136759,65,l,141,76
P,2,136900,88,l,283,195
P,2,137183,72,.,101,29
P,2,137284,112, ,919,807
P,2,138203,212,I,2303,2091
P,2,140506,48,m,819,771
P,2,141325,147,M,264,117
P,2,141589,103,o,100,-3
P,2,141689,45,s,211,166
P,2,141900,76,t,122,46
P,2,142022,153,l,88,-65
P,2,142110,66,y,114,48
P,2,142224,133, ,275,142
P,2,142499,80,a,52,-28
P,2,142551,88,l,142,54
P,2,142693,121,l,155,34
P,2,142848,104, ,100,-4
P,2,142948,80,p,214,134
P,2,143162,92,i,28,-64
P,2,143190,72,z,148,76
P,2,143338,85,z,251,166
P,2,143589,96,a,121,25
P,2,143710,120, ,132,12
P,2,143842,100,i,104,4
P,2,143946,108,s,134,26
P,2,144080,73, ,450,377
P,2,144530,48,g,60,12
P,2,144590,80,o,618,538
P,2,145208,116,o,119,3
P,2,145327,101,d,160,59
P,2,145487,137, ,330,193
P,2,145817,88,a,104,16
P,2,145921,108,n,112,4
P,2,146033,68,d,100,32
P,2,146133,152, ,148,-4
P,2,146281,64,r,151,87
P,2,146432,48,r,4,-44
P,2,146436,64,e,713,649
P,2,147149,52,e,402,350
P,2,147551,64,e,219,155
P,2,147770,69,a,86,17
P,2,147856,65,l,143,78
P,2,147999,136,l,108,-28
P,2,148107,75,y,72,-3
P,2,148179,181, ,160,-21
P,2,148339,96,g,99,3
P,2,148438,81,o,151,70
P,2,148589,108,o,100,-8
P,2,148689,73,d,73,0
P,2,148762,107, ,87,-20
P,2,148849,84,p,225,141
P,2,149074,100,i,112,12
P,2,149186,69,z,141,72
P,2,149327,80,z,211,131
P,2,149538,76,a,80,4
P,2,149618,64, ,367,303
P,2,149985,88,b,89,1
P,2,150074,59,e,199,140
P,2,150273,53,a,219,166
P,2,150492,61,t,211,150
P,2,150703,84,s,56,-28
P,2,150759,68, ,175,107
P,2,150934,101,o,212,111
P,2,151146,100,u,92,-8
P,2,151238,92,t,116,24
P,2,151354,132, ,144,12
P,2,151498,80,m,192,112
P,2,151690,128,o,72,-56
P,2,151762,76,s,222,146
P,2,151984,80,t,76,-4
P,2,152060,120, ,178,58
P,2,152238,96,f,117,21
P,2,152355,64,o,149,85
P,2,152504,108,o,174,66
P,2,152678,76,d,225,149
P,2,152903,97,s,143,46
P,2,153046,137, ,2829,2692
P,2,155875,113,o,147,34
P,2,156022,72,d,218,146
P,2,156240,65,s,2822,2757
P,2,159062,112,.,384,272
P,2,159446,132, ,352,220
P,2,159798,124,D,273,149
P,2,160071,92,h,241,149
P,2,160312,52,a,82,30
P,2,160394,100,l,156,56
P,2,160550,139,l,84,-55
P,2,160634,123, ,221,98
P,2,160855,108,p,213,105
P,2,161068,100,i,101,1
P,2,161169,75,z,105,30
P,2,161274,108,z,415,307
P,2,161689,56,a,216,160
P,2,161905,132, ,143,11
P,2,162048,85,t,45,-40
P,2,162093,68,h,215,147
P,2,162308,64,o,189,125
P,2,162497,69,u,111,42
P,2,162608,57,g,98,41
P,2,162706,84,h,130,46
P,2,162836,92, ,152,60
P,2,162988,108,i,139,31
P,2,163127,64,s,209,145
P,2,163336,96, ,3062,2966
P,2,166398,125,a,227,102
P,2,166625,109, ,208,99
P,2,166833,116,s,256,140
P,2,167089,68,a,200,132
P,2,167289,56,d,87,31
P,2,167376,100, ,139,39
P,2,167515,52,a,232,180
P,2,167747,64,t,140,76
P,2,167887,68,t,216,148
P,2,168103,96,e,92,-4
P,2,168195,68,m,201,133
P,2,168396,108,p,149,41
P,2,168545,93,t,146,53
P,2,168691,125, ,222,97
P,2,168913,89,a,232,143
P,2,169145,80,t,60,-20
P,2,169205,112, ,72,-40
P,2,169277,88,p,199,111
P,2,169476,75,i,64,-11
P,2,169540,60,z,133,73
P,2,169673,60,z,199,139
P,2,169872,76,a,215,139
P,2,170087,121, ,4669,4548
P,2,174756,144,",",1736,1592
P,2,176492,88,a,100,12
P,2,176592,124,n,175,51
P,2,176767,88,d,157,69
P,2,176924,184, ,439,255
P,2,177363,112,t,129,17
P,2,177492,69,h,128,59
P,2,177620,120,e,100,-20
P,2,177720,76,y,104,28
P,2,177824,136, ,171,35
P,2,177995,68,r,164,96
P,2,178159,65,e,217,152
P,2,178376,52,a,110,58
P,2,178486,84,l,143,59
P,2,178629,156,l,159,3
P,2,178788,81,y,113,32
P,2,178901,136, ,140,4
P,2,179041,84,n,91,7
P,2,179132,89,e,160,71
P,2,179292,76,e,174,98
P,2,179466,68,d,83,15
P,2,179549,48, ,135,87
P,2,179684,68,t,75,7
P,2,179759,96,o,93,-3
P,2,179852,153, ,152,-1
P,2,180004,52,c,16,-36
P,2,180020,92,h,230,138
P,2,180250,48,a,19,-29
P,2,180269,97,n,206,109
P,2,180475,76,g,28,-48
P,2,180503,88,e,103,15
P,2,180606,128, ,150,22
P,2,180756,76,t,44,-32
P,2,180800,88,h,136,48
P,2,180936,105,e,80,-25
P,2,181016,120, ,137,17
P,2,181153,81,r,154,73
P,2,181307,68,e,191,123
P,2,181498,84,c,118,34
P,2,181616,72,i,208,136
P,2,181824,133,p,443,310
P,2,182267,65,e,290,225
P,2,182557,56,.,NA,NA
Q,1,113,112,F,294,182
Q,1,407,96,a,69,-27
Q,1,476,87,r,103,16
Q,1,579,81, ,119,38
Q,1,698,124,o,69,-55
Q,1,767,86,u,81,-5
Q,1,848,74,t,88,14
Q,1,936,70, ,102,32
Q,1,1038,108,i,76,-32
Q,1,1114,116,n,128,12
Q,1,1242,100,t,108,8
Q,1,1350,80,h,982,902
Q,1,2332,96, ,136,40
Q,1,2468,104,t,92,-12
Q,1,2560,89,h,102,13
Q,1,2662,76,e,56,-20
Q,1,2718,89, ,123,34
Q,1,2841,109,u,52,-57
Q,1,2893,88,n,134,46
Q,1,3027,76,c,105,29
Q,1,3132,84,h,99,15
Q,1,3231,117,a,84,-33
Q,1,3315,61,r,146,85
Q,1,3461,85,t,108,23
Q,1,3569,130,e,108,-22
Q,1,3677,80,d,73,-7
Q,1,3750,119, ,99,-20
Q,1,3849,81,b,80,-1
Q,1,3929,81,a,52,-29
Q,1,3981,92,c,88,-4
Q,1,4069,85,k,117,32
Q,1,4186,97,w,41,-56
Q,1,4227,122,a,103,-19
Q,1,4330,89,t,133,44
Q,1,4463,116,e,71,-45
Q,1,4534,100,r,64,-36
Q,1,4598,120,s,92,-28
Q,1,4690,88, ,68,-20
Q,1,4758,89,o,96,7
Q,1,4854,64,f,57,-7
Q,1,4911,75, ,106,31
Q,1,5017,96,t,48,-48
Q,1,5065,76,h,98,22
Q,1,5163,103,e,84,-19
Q,1,5247,105, ,56,-49
Q,1,5303,100,u,68,-32
Q,1,5371,99,n,111,12
Q,1,5482,128,f,89,-39
Q,1,5571,124,a,83,-41
Q,1,5654,108,s,155,47
Q,1,5809,104,h,201,97
Q,1,6010,236,i,85,-151
Q,1,6095,140,o,100,-40
Q,1,6195,111,n,140,29
Q,1,6335,89,a,111,22
Q,1,6446,96,b,69,-27
Q,1,6515,95,l,107,12
Q,1,6622,57,e,93,36
Q,1,6715,85, ,130,45
Q,1,6845,60,e,53,-7
Q,1,6898,64,n,111,47
Q,1,7009,81,d,52,-29
Q,1,7061,96, ,110,14
Q,1,7171,80,o,91,11
Q,1,7262,39,f,36,-3
Q,1,7298,61, ,264,203
Q,1,7562,153,t,146,-7
Q,1,7708,75,h,125,50
Q,1,7833,55,e,697,642
Q,1,8530,63,e,86,23
Q,1,8616,89, ,202,113
Q,1,8818,108,w,77,-31
Q,1,8895,67,e,151,84
Q,1,9046,128,s,108,-20
Q,1,9154,89,t,131,42
Q,1,9285,104,e,89,-15
Q,1,9374,83,r,52,-31
Q,1,9426,107,n,83,-24
Q,1,9509,77, ,90,13
Q,1,9599,85,s,88,3
Q,1,9687,112,p,84,-28
Q,1,9771,89,i,96,7
Q,1,9867,101,r,57,-44
Q,1,9924,120,a,99,-21
Q,1,10023,111,l,89,-22
Q,1,10112,84, ,132,48
Q,1,10244,91,a,68,-23
Q,1,10312,75,r,43,-32
Q,1,10355,109,m,76,-33
Q,1,10431,97, ,114,17
Q,1,10545,85,o,88,3
Q,1,10633,60,f,57,-3
Q,1,10690,91, ,105,14
Q,1,10795,91,t,72,-19
Q,1,10867,72,h,80,8
Q,1,10947,96,e,93,-3
Q,1,11040,96, ,168,72
Q,1,11208,72,G,140,68
Q,1,11348,37,a,52,15
Q,1,11400,85,l,116,31
Q,1,11516,80,a,811,731
Q,1,12327,89,x,136,47
Q,1,12463,109,y,589,480
Q,1,13052,108, ,182,74
Q,1,13234,136,l,80,-56
Q,1,13314,108,i,170,62
Q,1,13484,152,e,159,7
Q,1,13643,57,s,27414,27357
Q,1,41057,66, ,92,26
Q,1,41149,81,a,87,6
Q,1,41236,78, ,104,26
Q,1,41340,80,s,95,15
Q,1,41435,85,m,92,7
Q,1,41527,85,a,85,0
Q,1,41612,44,l,131,87
Q,1,41743,100,l,72,-28
Q,1,41815,93, ,159,66
Q,1,41974,120,u,76,-44
Q,1,42050,108,n,207,99
Q,1,42257,136,r,100,-36
Q,1,42357,107,e,176,69
Q,1,42533,116,g,151,35
Q,1,42684,119,a,95,-24
Q,1,42779,77,r,202,125
Q,1,42981,108,d,92,-16
Q,1,43073,172,e,116,-56
Q,1,43189,107,d,123,16
Q,1,43312,53, ,121,68
Q,1,43433,97,y,118,21
Q,1,43551,101,e,139,38
Q,1,43690,90,l,185,95
Q,1,43875,116,l,84,-32
Q,1,43959,116,o,59,-57
Q,1,44018,84,w,109,25
Q,1,44127,88, ,100,12
Q,1,44227,84,s,80,-4
Q,1,44307,76,u,69,-7
Q,1,44376,52,n,237,185
Q,1,44613,112,.,111,-1
Q,1,44724,128, ,2254,2126
Q,1,46978,76,O,249,173
Q,1,47227,88,r,729,641
Q,1,47956,44,b,3346,3302
Q,1,51302,112,i,123,11
Q,1,51425,101,t,199,98
Q,1,51624,120,i,84,-36
Q,1,51708,99,n,80,-19
Q,1,51788,84,g,115,31
Q,1,51903,80, ,79,-1
Q,1,51982,100,t,72,-28
Q,1,52054,140,h,72,-68
Q,1,52126,114,i,98,-16
Q,1,52224,95,s,67,-28
Q,1,52291,96, ,150,54
Q,1,52441,95,a,92,-3
Q,1,52533,92,t,72,-20
Q,1,52605,72, ,55,-17
Q,1,52660,85,a,108,23
Q,1,52768,56, ,81,25
Q,1,52849,65,d,86,21
Q,1,52935,116,i,89,-27
Q,1,53024,127,s,116,-11
Q,1,53140,95,t,88,-7
Q,1,53228,88,a,89,1
Q,1,53317,102,n,91,-11
Q,1,53408,104,c,80,-24
Q,1,53488,119,e,60,-59
Q,1,53548,88, ,67,-21
Q,1,53615,85,o,113,28
Q,1,53728,96,f,49,-47
Q,1,53777,88, ,201,113
Q,1,53978,72,r,69,-3
Q,1,54047,89,o,59,-30
Q,1,54106,101,u,112,11
Q,1,54218,80,g,92,12
Q,1,54310,65,h,144,79
Q,1,54454,80,l,81,1
Q,1,54535,91,y,127,36
Q,1,54662,84, ,228,144
Q,1,54890,99,n,76,-23
Q,1,54966,116,i,133,17
Q,1,55099,108,n,80,-28
Q,1,55179,96,e,166,70
Q,1,55345,100,t,201,101
Q,1,55546,89,y,403,314
Q,1,55949,116,t,372,256
Q,1,56321,72,t,473,401
Q,1,56794,84,w,131,47
Q,1,56925,133,o,93,-40
Q,1,57018,104, ,407,303
Q,1,57425,100,m,64,-36
Q,1,57489,146,i,124,-22
Q,1,57613,92,l,225,133
Q,1,57838,67,l,64,-3
Q,1,57902,112,i,92,-20
Q,1,57994,52,l,855,803
Q,1,58849,152,o,112,-40
Q,1,58961,115,n,87,-28
Q,1,59048,130, ,175,45
Q,1,59223,112,m,68,-44
Q,1,59291,141,i,51,-90
Q,1,59342,137,l,108,-29
Q,1,59450,153,e,89,-64
Q,1,59539,92,s,48,-44
Q,1,59587,99, ,80,-19
Q,1,59667,88,i,95,7
Q,1,59762,64,s,61,-3
Q,1,59823,89, ,105,16
Q,1,59928,113,a,97,-16
Q,1,60025,88,n,52,-36
Q,1,60077,133, ,132,-1
Q,1,60209,104,u,76,-28
Q,1,60285,60,n,429,369
Q,1,60714,70,t,136,66
Q,1,60850,80,t,122,42
Q,1,60972,108,e,88,-20
Q,1,61060,85,r,114,29
Q,1,61174,54,l,126,72
Q,1,61300,136,y,108,-28
Q,1,61408,96, ,145,49
Q,1,61553,136,i,96,-40
Q,1,61649,112,n,728,616
Q,1,62377,80,s,117,37
Q,1,62494,81,i,104,23
Q,1,62598,90,g,125,35
Q,1,62723,119,n,64,-55
Q,1,62787,117,i,116,-1
Q,1,62903,73,f,107,34
Q,1,63010,84,i,95,11
Q,1,63105,89,c,49,-40
Q,1,63154,100,a,108,8
Q,1,63262,104,n,155,51
Q,1,63417,68,t,152,84
Q,1,63569,89, ,127,38
Q,1,63696,108,l,60,-48
Q,1,63756,96,i,64,-32
Q,1,63820,60,t,148,88
Q,1,63968,71,t,68,-3
Q,1,64036,92,l,76,-16
Q,1,64112,75,e,48,-27
Q,1,64160,112, ,119,7
Q,1,64279,129,b,117,-12
Q,1,64396,232,l,136,-96
Q,1,64532,115,u,108,-7
Q,1,64640,88,e,114,26
Q,1,64754,89, ,92,3
Q,1,64846,69,g,186,117
Q,1,65032,91,r,35,-56
Q,1,65067,96,e,152,56
Q,1,65219,84,e,85,1
Q,1,65304,44,n,27,-17
Q,1,65331,109, ,187,78
Q,1,65518,136,p,60,-76
Q,1,65578,116,l,119,3
Q,1,65697,69,a,111,42
Q,1,65808,57,n,167,110
Q,1,65975,81,e,918,837
Q,1,66893,100,t,112,12
Q,1,67005,45, ,156,111
Q,1,67161,68,w,48,-20
Q,1,67209,100,h,60,-40
Q,1,67269,104,o,159,55
Q,1,67428,124,s,80,-44
Q,1,67508,96,e,92,-4
Q,1,67600,109, ,122,13
Q,1,67722,92,a,68,-24
Q,1,67790,73,p,138,65
Q,1,67928,89,e,270,181
Q,1,68198,108,d,60,-48
Q,1,68258,108,e,769,661
Q,1,69027,91,s,137,46
Q,1,69164,156,c,145,-11
Q,1,69309,91,e,112,21
Q,1,69421,97,n,76,-21
Q,1,69497,90,d,68,-22
Q,1,69565,173,e,108,-65
Q,1,69673,116,d,76,-40
Q,1,69749,125, ,72,-53
Q,1,69821,149,l,84,-65
Q,1,69905,96,i,100,4
Q,1,70005,60,f,20,-40
Q,1,70025,104,e,88,-16
Q,1,70113,108, ,111,3
Q,1,70224,78,f,66,-12
Q,1,70290,80,o,109,29
Q,1,70399,79,r,77,-2
Q,1,70476,92,m,112,20
Q,1,70588,85,s,103,18
Q,1,70691,105, ,105,0
Q,1,70796,91,a,92,1
Q,1,70888,107,r,67,-40
Q,1,70955,84,e,92,8
Q,1,71047,81, ,92,11
Q,1,71139,108,s,80,-28
Q,1,71219,100,o,64,-36
Q,1,71283,81, ,110,29
Q,1,71393,96,a,108,12
Q,1,71501,101,m,53,-48
Q,1,71554,107,i,193,86
Q,1,71747,101,z,112,11
Q,1,71859,105,i,69,-36
Q,1,71928,91,n,99,8
Q,1,72027,85,g,107,22
Q,1,72134,84,l,311,227
Q,1,72445,121,y,141,20
Q,1,72586,97, ,131,34
Q,1,72717,108,p,135,27
Q,1,72852,45,r,144,99
Q,1,72996,96,i,80,-16
Q,1,73076,125,m,125,0
Q,1,73201,127,i,115,-12
Q,1,73316,89,t,151,62
Q,1,73467,85,i,106,21
Q,1,73573,117,v,72,-45
Q,1,73645,92,e,100,8
Q,1,73745,97, ,121,24
Q,1,73866,68,t,64,-4
Q,1,73930,85,h,118,33
Q,1,74048,100,a,52,-48
Q,1,74100,104,t,60,-44
Q,1,74160,104, ,150,46
Q,1,74310,83,t,55,-28
Q,1,74365,88,h,124,36
Q,1,74489,115,e,79,-36
Q,1,74568,96,y,76,-20
Q,1,74644,76, ,88,12
Q,1,74732,73,t,372,299
Q,1,75104,92,s,44,-48
Q,1,75148,84,t,92,8
Q,1,75240,100,i,32,-68
Q,1,75272,104,l,194,90
Q,1,75466,108,l,64,-44
Q,1,75530,96, ,76,-20
Q,1,75606,100,t,76,-24
Q,1,75682,92,h,48,-44
Q,1,75730,88,i,169,81
Q,1,75899,134,n,63,-71
Q,1,75962,96,k,56,-40
Q,1,76018,108, ,96,-12
Q,1,76114,85,d,101,16
Q,1,76215,73,i,100,27
Q,1,76315,53,g,74,21
Q,1,76389,84,i,88,4
Q,1,76477,108,t,73,-35
Q,1,76550,96,a,43,-53
Q,1,76593,144,l,112,-32
Q,1,76705,93, ,71,-22
Q,1,76776,126,w,60,-66
Q,1,76836,121,a,117,-4
Q,1,76953,89,t,206,117
Q,1,77159,95,c,91,-4
Q,1,77250,84,h,122,38
Q,1,77372,125,e,60,-65
Q,1,77432,132,s,100,-32
Q,1,77532,104, ,268,164
Q,1,77800,104,a,173,69
Q,1,77973,117,r,68,-49
Q,1,78041,104,e,84,-20
Q,1,78125,80, ,84,4
Q,1,78209,92,a,85,-7
Q,1,78294,76, ,110,34
Q,1,78404,117,p,56,-61
Q,1,78460,108,r,63,-45
Q,1,78523,85,e,189,104
Q,1,78712,64,t,128,64
Q,1,78840,81,t,166,85
Q,1,79006,60,y,56,-4
Q,1,79062,104, ,108,4
Q,1,79170,80,h,437,357
Q,1,79607,112,n,72,-40
Q,1,79679,143,e,75,-68
Q,1,79754,109,a,72,-37
Q,1,79826,84,t,101,17
Q,1,79927,73, ,160,87
Q,1,80087,63, ,31,-32
Q,1,80118,112,i,115,3
Q,1,80233,166,d,61,-105
Q,1,80294,173,e,104,-69
Q,1,80398,104,a,1378,1274
Q,1,81776,89, ,829,740
Q,1,82605,104, ,1114,1010
Q,1,83719,92,t,186,94
Q,1,83905,105, ,282,177
Q,1,84187,104, ,1175,1071
Q,1,85362,124, ,342,218
Q,1,85704,108, ,2398,2290
Q,1,88102,100, ,810,710
Q,1,88912,68, ,424,356
Q,1,89336,108,i,88,-20
Q,1,89424,136,d,72,-64
Q,1,89496,144,e,67,-77
Q,1,89563,104,a,216,112
Q,1,89779,100,.,1423,1323
Q,1,91202,80,T,148,68
Q,1,91350,124,h,79,-45
Q,1,91429,72,i,64,-8
Q,1,91493,92,s,60,-32
Q,1,91553,109, ,124,15
Q,1,91677,145,p,49,-96
Q,1,91726,148,l,177,29
Q,1,91903,109,a,568,459
Q,1,92471,80,n,81,1
Q,1,92552,83,t,507,424
Q,1,93059,71,e,60,-11
Q,1,93119,73,t,189,116
Q,1,93308,96, ,222,126
Q,1,93530,60, ,1339,1279
Q,1,94869,88,a,96,8
Q,1,94965,88,n,112,24
Q,1,95077,104,e,68,-36
Q,1,95145,96,t,72,-24
Q,1,95217,68, ,570,502
Q,1,95787,89, ,1256,1167
Q,1,97043,110,h,95,-15
Q,1,97138,97,a,49,-48
Q,1,97187,124,s,182,58
Q,1,97369,108,",",276,168
Q,1,97645,96, ,181,85
Q,1,97826,85,o,88,3
Q,1,97914,74,r,89,15
Q,1,98003,89, ,118,29
Q,1,98121,87,r,47,-40
Q,1,98168,88,a,158,70
Q,1,98326,81,t,132,51
Q,1,98458,113,e,93,-20
Q,1,98551,88,r,118,30
Q,1,98669,113, ,1420,1307
Q,1,100089,91,h,80,-11
Q,1,100169,92,e,68,-24
Q,1,100237,96,r,99,3
Q,1,100336,98, ,270,172
Q,1,100606,80, ,670,590
Q,1,101276,88, ,222,134
Q,1,101498,100, ,863,763
Q,1,102361,53, ,1357,1304
Q,1,103718,61, ,211,150
Q,1,103929,68,h,71,3
Q,1,104000,133,a,93,-40
Q,1,104093,116,d,160,44
Q,1,104253,117,",",100,-17
Q,1,104353,49, ,257,208
Q,1,104610,112,a,177,65
Q,1,104787,119, ,407,288
Q,1,105194,104,p,150,46
Q,1,105344,69,r,1593,1524
Q,1,106937,92,p,77,-15
Q,1,107014,76,r,101,25
Q,1,107115,93,o,116,23
Q,1,107231,74,b,95,21
Q,1,107326,84,l,125,41
Q,1,107451,87,e,69,-18
Q,1,107520,128,m,95,-33
Q,1,107615,133, ,2198,2065
Q,1,109813,90,o,83,-7
Q,1,109896,97,b,157,60
Q,1,110053,81,l,139,58
Q,1,110192,80,e,161,81
Q,1,110353,121,m,276,155
Q,1,110629,108,",",67,-41
Q,1,110696,105, ,142,37
Q,1,110838,98,w,148,50
Q,1,110986,164,h,43,-121
Q,1,111029,113,i,165,52
Q,1,111194,90,c,96,6
Q,1,111290,124,h,84,-40
Q,1,111374,104, ,68,-36
Q,1,111442,108,w,68,-40
Q,1,111510,180,a,108,-72
Q,1,111618,157,s,128,-29
Q,1,111746,78, ,132,54
Q,1,111878,112,t,137,25
Q,1,112015,161,h,88,-73
Q,1,112103,124,i,91,-33
Q,1,112194,133,s,362,229
Q,1,112556,155,:,71,-84
Q,1,112627,141, ,313,172
Q,1,112940,143,m,91,-52
Q,1,113031,101,o,56,-45
Q,1,113087,80,s,51,-29
Q,1,113138,89,t,77,-12
Q,1,113215,112, ,69,-43
Q,1,113284,122,o,99,-23
Q,1,113383,92,f,68,-24
Q,1,113451,76, ,127,51
Q,1,113578,108,t,27,-81
Q,1,113605,85,h,146,61
Q,1,113751,92,e,7,-85
Q,1,113758,113, ,117,4
Q,1,113875,101,p,161,60
Q,1,114036,101,e,84,-17
Q,1,114120,97,o,56,-41
Q,1,114176,253,p,136,-117
Q,1,114312,124,l,89,-35
Q,1,114401,87,e,59,-28
Q,1,114460,137, ,136,-1
Q,1,114596,149,o,92,-57
Q,1,114688,112,n,64,-48
Q,1,114752,92, ,104,12
Q,1,114856,96,i,68,-28
Q,1,114924,84,t,77,-7
Q,1,115001,99, ,116,17
Q,1,115117,133,w,81,-52
Q,1,115198,90,e,71,-19
Q,1,115269,125,r,84,-41
Q,1,115353,136,e,64,-72
Q,1,115417,145, ,88,-57
Q,1,115505,84,u,56,-28
Q,1,115561,73,n,163,90
Q,1,115724,76,h,35,-41
Q,1,115759,106,a,175,69
Q,1,115934,61,p,138,77
Q,1,116072,89,p,36,-53
Q,1,116108,76,y,129,53
Q,1,116237,113, ,135,22
Q,1,116372,93,f,120,27
Q,1,116492,93,o,118,25
Q,1,116610,95,r,77,-18
Q,1,116687,124, ,135,11
Q,1,116822,99,p,80,-19
Q,1,116902,97,r,56,-41
Q,1,116958,105,e,158,53
Q,1,117116,64,t,133,69
Q,1,117249,77,t,166,89
Q,1,117415,92,y,80,-12
Q,1,117495,134, ,133,-1
Q,1,117628,175,m,152,-23
Q,1,117780,107,u,125,18
Q,1,117905,91,c,69,-22
Q,1,117974,112,h,67,-45
Q,1,118041,100, ,148,48
Q,1,118189,137,o,80,-57
Q,1,118269,68,f,89,21
Q,1,118358,65, ,83,18
Q,1,118441,93,t,92,-1
Q,1,118533,105,h,85,-20
Q,1,118618,99,e,103,4
Q,1,118721,100, ,179,79
Q,1,118900,88,t,60,-28
Q,1,118960,83,i,63,-20
Q,1,119023,97,m,110,13
Q,1,119133,85,e,147,62
Q,1,119280,108,.,33,-75
Q,1,119313,123, ,2295,2172
Q,1,121608,83,M,124,41
Q,1,121732,80,a,77,-3
Q,1,121809,100,n,116,16
Q,1,121925,101,y,112,11
Q,1,122037,120, ,89,-31
Q,1,122126,97,s,67,-30
Q,1,122193,97,o,110,13
Q,1,122303,117,l,185,68
Q,1,122488,65,u,76,11
Q,1,122564,85,t,104,19
Q,1,122668,180,i,49,-131
Q,1,122717,141,o,71,-70
Q,1,122788,109,n,52,-57
Q,1,122840,92,s,130,38
Q,1,122970,109, ,93,-16
Q,1,123063,112,w,64,-48
Q,1,123127,111,e,87,-24
Q,1,123214,143,r,121,-22
Q,1,123335,119,e,361,242
Q,1,123696,84, ,109,25
Q,1,123805,89,s,110,21
Q,1,123915,96,u,93,-3
Q,1,124008,40,g,132,92
Q,1,124140,128,g,76,-52
Q,1,124216,176,e,87,-89
Q,1,124303,118,s,100,-18
Q,1,124403,126,t,125,-1
Q,1,124528,148,e,116,-32
Q,1,124644,127,d,107,-20
Q,1,124751,117, ,148,31
Q,1,124899,57,f,68,11
Q,1,124967,81,o,92,11
Q,1,125059,87,r,85,-2
Q,1,125144,115, ,91,-24
Q,1,125235,92,t,68,-24
Q,1,125303,93,h,72,-21
Q,1,125375,96,i,49,-47
Q,1,125424,98,s,79,-19
Q,1,125503,112, ,101,-11
Q,1,125604,75,p,72,-3
Q,1,125676,56,r,106,50
Q,1,125782,88,o,80,-8
Q,1,125862,77,b,134,57
Q,1,125996,89,l,120,31
Q,1,126116,69,e,97,28
Q,1,126213,57,m,313,256
Q,1,126526,141,",",85,-56
Q,1,126611,120, ,241,121
Q,1,126852,136,b,80,-56
Q,1,126932,96,u,57,-39
Q,1,126989,107,t,127,20
Q,1,127116,116, ,91,-25
Q,1,127207,125,m,72,-53
Q,1,127279,85,o,60,-25
Q,1,127339,89,s,49,-40
Q,1,127388,68,t,80,12
Q,1,127468,120, ,76,-44
Q,1,127544,79,o,71,-8
Q,1,127615,75,f,65,-10
Q,1,127680,76, ,102,26
Q,1,127782,92,t,68,-24
Q,1,127850,88,h,92,4
Q,1,127942,89,e,61,-28
Q,1,128003,140,s,95,-45
Q,1,128098,106,e,92,-14
Q,1,128190,93, ,121,28
Q,1,128311,113,w,65,-48
Q,1,128376,112,e,80,-32
Q,1,128456,160,r,92,-68
Q,1,128548,124,e,79,-45
Q,1,128627,109, ,52,-57
Q,1,128679,133,l,92,-41
Q,1,128771,93,a,53,-40
Q,1,128824,60,r,170,110
Q,1,128994,112,g,56,-56
Q,1,129050,112,e,75,-37
Q,1,129125,125,l,136,11
Q,1,129261,112,y,85,-27
Q,1,129346,124, ,251,127
Q,1,129597,75,c,72,-3
Q,1,129669,91,o,56,-35
Q,1,129725,124,n,91,-33
Q,1,129816,88,c,178,90
Q,1,129994,95,e,68,-27
Q,1,130062,120,r,127,7
Q,1,130189,93,n,33,-60
Q,1,130222,103,e,2689,2586
Q,1,132911,120,n,164,44
Q,1,133075,172,e,100,-72
Q,1,133175,144,d,195,51
Q,1,133370,100, ,234,134
Q,1,133604,92,w,109,17
Q,1,133713,93,i,94,1
Q,1,133807,127,t,108,-19
Q,1,133915,106,h,72,-34
Q,1,133987,101, ,74,-27
Q,1,134061,101,t,69,-32
Q,1,134130,84,h,95,11
Q,1,134225,105,e,46,-59
Q,1,134271,134, ,123,-11
Q,1,134394,146,m,80,-66
Q,1,134474,100,o,40,-60
Q,1,134514,124,v,162,38
Q,1,134676,96,m,103,7
Q,1,134779,53,e,464,411
Q,1,135243,73,e,95,22
Q,1,135338,96,m,89,-7
Q,1,135427,88,e,91,3
Q,1,135518,93,n,104,11
Q,1,135622,117,t,81,-36
Q,1,135703,120,s,63,-57
Q,1,135766,145, ,109,-36
Q,1,135875,108,o,129,21
Q,1,136004,104,f,107,3
Q,1,136111,105, ,141,36
Q,1,136252,76,s,93,17
Q,1,136345,85,m,114,29
Q,1,136459,109,a,61,-48
Q,1,136520,64,l,132,68
Q,1,136652,160,l,95,-65
Q,1,136747,129, ,591,462
Q,1,137338,92,g,204,112
Q,1,137542,112,r,56,-56
Q,1,137598,84,e,153,69
Q,1,137751,108,e,64,-44
Q,1,137815,79,n,55,-24
Q,1,137870,85, ,144,59
Q,1,138014,108,p,120,12
Q,1,138134,60,r,453,393
Q,1,138587,116,i,76,-40
Q,1,138663,119,e,111,-8
Q,1,138774,215,c,101,-114
Q,1,138875,160,e,84,-76
Q,1,138959,131,s,128,-3
Q,1,139087,124, ,92,-32
Q,1,139179,104,o,68,-36
Q,1,139247,104,f,105,1
Q,1,139352,91, ,120,29
Q,1,139472,76,p,107,31
Q,1,139579,92,a,81,-11
Q,1,139660,104,p,156,52
Q,1,139816,108,e,92,-16
Q,1,139908,68,r,303,235
Q,1,140211,116,",",72,-44
Q,1,140283,108, ,184,76
Q,1,140467,90,w,64,-26
Q,1,140531,108,h,63,-45
Q,1,140594,97,i,133,36
Q,1,140727,83,c,47,-36
Q,1,140774,101,h,65,-36
Q,1,140839,87, ,63,-24
Q,1,140902,108,i,96,-12
Q,1,140998,101,s,77,-24
Q,1,141075,80, ,154,74
Q,1,141229,120,o,221,101
Q,1,141450,68,d,138,70
Q,1,141588,100,d,52,-48
Q,1,141640,132, ,112,-20
Q,1,141752,96,b,52,-44
Q,1,141804,160,e,76,-84
Q,1,141880,156,c,60,-96
Q,1,141940,103,a,99,-4
Q,1,142039,69,u,112,43
Q,1,142151,92,s,44,-48
Q,1,142195,84,e,182,98
Q,1,142377,185, ,252,67
Q,1,142629,95,o,64,-31
Q,1,142693,120,n,60,-60
Q,1,142753,124, ,92,-32
Q,1,142845,100,t,118,18
Q,1,142963,77,h,53,-24
Q,1,143016,98,e,72,-26
Q,1,143088,97, ,135,38
Q,1,143223,82,w,93,11
Q,1,143316,106,h,67,-39
Q,1,143383,108,o,188,80
Q,1,143571,141,l,143,2
Q,1,143714,66,e,116,50
Q,1,143830,97, ,115,18
Q,1,143945,80,i,110,30
Q,1,144055,80,t,88,8
Q,1,144143,107, ,92,-15
Q,1,144235,95,w,76,-19
Q,1,144311,168,a,120,-48
Q,1,144431,184,s,59,-125
Q,1,144490,101,n,234,133
Q,1,144724,77,',100,23
Q,1,144824,82,t,564,482
Q,1,145388,73, ,86,13
Q,1,145474,88,t,100,12
Q,1,145574,72,h,75,3
Q,1,145649,89,e,77,-12
Q,1,145726,113, ,140,27
Q,1,145866,80,s,92,12
Q,1,145958,65,m,102,37
Q,1,146060,104,a,80,-24
Q,1,146140,48,l,126,78
Q,1,146266,116,l,64,-52
Q,1,146330,159, ,152,-7
Q,1,146482,73,g,180,107
Q,1,146662,132,r,72,-60
Q,1,146734,80,e,150,70
Q,1,146884,84,e,36,-48
Q,1,146920,81,n,59,-22
Q,1,146979,102, ,123,21
Q,1,147102,115,p,112,-3
Q,1,147214,85,r,120,35
Q,1,147334,113,i,512,399
Q,1,147846,112,i,100,-12
Q,1,147946,88,r,626,538
Q,1,148572,85,e,455,370
Q,1,149027,66,c,252,186
Q,1,149279,140,e,76,-64
Q,1,149355,104,s,72,-32
Q,1,149427,100, ,486,386
Q,1,149913,33,o,45,12
Q,1,149958,62,f,293,231
Q,1,150251,96, ,241,145
Q,1,150492,77,p,76,-1
Q,1,150568,89,a,104,15
Q,1,150672,117,p,139,22
Q,1,150811,121,e,89,-32
Q,1,150900,72,r,96,24
Q,1,150996,81, ,1894,1813
Q,1,152890,91,t,98,7
Q,1,152988,81,h,133,52
Q,1,153121,93,a,52,-41
Q,1,153173,100,t,103,3
Q,1,153276,110, ,128,18
Q,1,153404,151,w,76,-75
Q,1,153480,104,e,61,-43
Q,1,153541,168,r,115,-53
Q,1,153656,148,e,84,-64
Q,1,153740,136, ,128,-8
Q,1,153868,120,u,64,-56
Q,1,153932,96,n,190,94
Q,1,154122,68,h,82,14
Q,1,154204,82,a,105,23
Q,1,154309,65,p,128,63
Q,1,154437,87,p,65,-22
Q,1,154502,84,y,372,288
Q,1,154874,108,.,104,-4
Q,1,154978,109, ,1915,1806
Q,1,156893,57, ,NA,NA
Q,2,64,105,M,231,126
Q,2,295,101,y,140,39
Q,2,435,113, ,300,187
Q,2,735,164,f,108,-56
Q,2,843,117,a,318,201
Q,2,1161,85,v,146,61
Q,2,1307,108,o,212,104
Q,2,1519,76,r,97,21
Q,2,1616,97,i,187,90
Q,2,1803,108,t,52,-56
Q,2,1855,116,e,119,3
Q,2,1974,105, ,162,57
Q,2,2136,77,f,94,17
Q,2,2230,57,o,156,99
Q,2,2386,84,o,95,11
Q,2,2481,69,d,122,53
Q,2,2603,129, ,128,-1
Q,2,2731,68,i,102,34
Q,2,2833,78,s,173,95
Q,2,3006,71, ,32393,32322
Q,2,35399,84,c,123,39
Q,2,35522,107,h,134,27
Q,2,35656,68,e,147,79
Q,2,35803,88,e,155,67
Q,2,35958,103,s,64,-39
Q,2,36022,92,e,236,144
Q,2,36258,129,.,57,-72
Q,2,36315,112, ,218,106
Q,2,36533,105,I,112,7
Q,2,36645,69,t,80,11
Q,2,36725,105, ,126,21
Q,2,36851,128,r,67,-61
Q,2,36918,156,e,64,-92
Q,2,36982,100,a,53,-47
Q,2,37035,60,l,144,84
Q,2,37179,96,l,295,199
Q,2,37474,92,y,67,-25
Q,2,37541,100, ,143,43
Q,2,37684,90,i,84,-6
Q,2,37768,90,s,63,-27
Q,2,37831,96, ,99,3
Q,2,37930,86,t,50,-36
Q,2,37980,88,h,104,16
Q,2,38084,80,e,69,-11
Q,2,38153,91, ,84,-7
Q,2,38237,103,b,84,-19
Q,2,38321,175,e,76,-99
Q,2,38397,120,s,96,-24
Q,2,38493,85,t,149,64
Q,2,38642,69, ,443,374
Q,2,39085,108,",",68,-40
Q,2,39153,104, ,143,39
Q,2,39296,104,p,2835,2731
Q,2,42131,104,.,52,-52
Q,2,42183,112, ,422,310
Q,2,42605,68,Y,88,20
Q,2,42693,124,o,72,-52
Q,2,42765,112,u,56,-56
Q,2,42821,104, ,166,62
Q,2,42987,120,a,56,-64
Q,2,43043,128,n,80,-48
Q,2,43123,140, ,691,551
Q,2,43814,128,c,44,-84
Q,2,43858,113,a,137,24
Q,2,43995,112,n,48,-64
Q,2,44043,129, ,164,35
Q,2,44207,77,d,53,-24
Q,2,44260,124,o,84,-40
Q,2,44344,72, ,71,-1
Q,2,44415,104,a,116,12
Q,2,44531,85,n,96,11
Q,2,44627,97,y,184,87
Q,2,44811,96,t,48,-48
Q,2,44859,95,h,67,-28
Q,2,44926,140,i,108,-32
Q,2,45034,105,n,49,-56
Q,2,45083,92,g,110,18
Q,2,45193,88, ,92,4
Q,2,45285,88,w,88,0
Q,2,45373,68,i,81,13
Q,2,45454,84,t,48,-36
Q,2,45502,112,h,85,-27
Q,2,45587,108, ,108,0
Q,2,45695,104,i,88,-16
Q,2,45783,76,t,2077,2001
Q,2,47860,124,.,76,-48
Q,2,47936,121, ,769,648
Q,2,48705,44,P,377,333
Q,2,49082,95,u,84,-11
Q,2,49166,80,t,91,11
Q,2,49257,81, ,244,163
Q,2,49501,125,i,984,859
Q,2,50485,59,t,56,-3
Q,2,50541,112, ,135,23
Q,2,50676,136,o,72,-64
Q,2,50748,126,n,112,-14
Q,2,50860,48, ,81,33
Q,2,50941,68, ,711,643
Q,2,51652,106, ,88,-18
Q,2,51740,92,a,99,7
Q,2,51839,88, ,117,29
Q,2,51956,76,s,36,-40
Q,2,51992,107,a,96,-11
Q,2,52088,81,n,129,48
Q,2,52217,76,w,534,458
Q,2,52751,61,d,146,85
Q,2,52897,76,w,83,7
Q,2,52980,65,i,107,42
Q,2,53087,89,c,49,-40
Q,2,53136,79,h,234,155
Q,2,53370,120,",",61,-59
Q,2,53431,95, ,125,30
Q,2,53556,60,t,63,3
Q,2,53619,161,o,81,-80
Q,2,53700,108,p,57,-51
Q,2,53757,98, ,102,4
Q,2,53859,89,y,108,19
Q,2,53967,153,o,60,-93
Q,2,54027,98,u,96,-2
Q,2,54123,61,r,92,31
Q,2,54215,93, ,105,12
Q,2,54320,84,f,48,-36
Q,2,54368,76,a,279,203
Q,2,54647,108,o,376,268
Q,2,55023,94,v,149,55
Q,2,55172,60,o,82,22
Q,2,55254,61,r,93,32
Q,2,55347,76,i,91,15
Q,2,55438,103,t,87,-16
Q,2,55525,67,e,52,-15
Q,2,55577,124, ,84,-40
Q,2,55661,132,p,72,-60
Q,2,55733,120,a,64,-56
Q,2,55797,92,s,160,68
Q,2,55957,119,t,87,-32
Q,2,56044,124,a,96,-28
Q,2,56140,88, ,120,32
Q,2,56260,93,w,92,-1
Q,2,56352,73,i,102,29
Q,2,56454,97,t,84,-13
Q,2,56538,139,h,44,-95
Q,2,56582,99, ,72,-27
Q,2,56654,103,i,96,-7
Q,2,56750,88,t,216,128
Q,2,56966,107,",",59,-48
Q,2,57025,108, ,389,281
Q,2,57414,95,o,75,-20
Q,2,57489,65,r,96,31
Q,2,57585,97, ,1006,909
Q,2,58591,144,e,146,2
Q,2,58737,118,v,73,-45
Q,2,58810,131,e,84,-47
Q,2,58894,108,n,51,-57
Q,2,58945,126, ,164,38
Q,2,59109,233,e,84,-149
Q,2,59193,149,a,128,-21
Q,2,59321,117,t,133,16
Q,2,59454,112, ,72,-40
Q,2,59526,104,i,107,3
Q,2,59633,102,t,118,16
Q,2,59751,57, ,217,160
Q,2,59968,101,a,141,40
Q,2,60109,137,l,72,-65
Q,2,60181,121,o,240,119
Q,2,60421,73,n,117,44
Q,2,60538,69,e,1238,1169
Q,2,61776,119,.,79,-40
Q,2,61855,68, ,4203,4135
Q,2,66058,93,W,132,39
Q,2,66190,151,h,120,-31
Q,2,66310,116,o,15,-101
Q,2,66325,121, ,543,422
Q,2,66868,88,w,51,-37
Q,2,66919,116,o,104,-12
Q,2,67023,73,u,171,98
Q,2,67194,76,l,139,63
Q,2,67333,97,d,142,45
Q,2,67475,100,n,321,221
Q,2,67796,56,',88,32
Q,2,67884,85,t,472,387
Q,2,68356,100, ,173,73
Q,2,68529,124,w,56,-68
Q,2,68585,103,a,117,14
Q,2,68702,93,n,112,19
Q,2,68814,45,t,61,16
Q,2,68875,121, ,134,13
Q,2,69009,98,s,97,-1
Q,2,69106,99,o,64,-35
Q,2,69170,75,m,72,-3
Q,2,69242,120,e,75,-45
Q,2,69317,96,t,72,-24
Q,2,69389,101,h,56,-45
Q,2,69445,137,i,140,3
Q,2,69585,112,n,57,-55
Q,2,69642,83,g,51,-32
Q,2,69693,136, ,128,-8
Q,2,69821,100,l,56,-44
Q,2,69877,88,i,164,76
Q,2,70041,69,k,45,-24
Q,2,70086,99,e,75,-24
Q,2,70161,92, ,100,8
Q,2,70261,77,t,97,20
Q,2,70358,65,h,78,13
Q,2,70436,91,a,56,-35
Q,2,70492,81,t,367,286
Q,2,70859,76, ,844,768
Q,2,71703,88,A,718,630
Q,2,72421,92,A,1036,944
Q,2,73457,111,D,99,-12
Q,2,73556,92,o,65,-27
Q,2,73621,92, ,91,-1
Q,2,73712,80,y,44,-36
Q,2,73756,152,o,68,-84
Q,2,73824,92,u,52,-40
Q,2,73876,85, ,133,48
Q,2,74009,84,h,23,-61
Q,2,74032,92,a,126,34
Q,2,74158,141,v,61,-80
Q,2,74219,139,e,81,-58
Q,2,74300,134, ,55,-79
Q,2,74355,168,m,68,-100
Q,2,74423,107,o,115,8
Q,2,74538,89,r,49,-40
Q,2,74587,128,e,135,7
Q,2,74722,89, ,130,41
Q,2,74852,75,o,72,-3
Q,2,74924,72,f,86,14
Q,2,75010,106, ,74,-32
Q,2,75084,84,a,163,79
Q,2,75247,72, ,79,7
Q,2,75326,117,s,323,206
Q,2,75649,112,w,72,-40
Q,2,75721,92,e,174,82
Q,2,75895,96,e,225,129
Q,2,76120,87,t,79,-8
Q,2,76199,93, ,160,67
Q,2,76359,68,t,84,16
Q,2,76443,69,o,167,98
Q,2,76610,68,o,112,44
Q,2,76722,84,t,111,27
Q,2,76833,65,h,613,548
Q,2,77446,96, ,958,862
Q,2,78404,92,T,103,11
Q,2,78507,93,h,118,25
Q,2,78625,93,e,394,301
Q,2,79019,84,y,1008,924
Q,2,80027,88, ,142,54
Q,2,80169,72,c,102,30
Q,2,80271,89,h,100,11
Q,2,80371,57,e,115,58
Q,2,80486,96,e,128,32
Q,2,80614,132,s,80,-52
Q,2,80694,92,e,63,-29
Q,2,80757,94, ,93,-1
Q,2,80850,108,p,111,3
Q,2,80961,77,e,78,1
Q,2,81039,98,o,87,-11
Q,2,81126,159,p,92,-67
Q,2,81218,100,l,64,-36
Q,2,81282,67,e,60,-7
Q,2,81342,119, ,112,-7
Q,2,81454,112,h,87,-25
Q,2,81541,104,a,105,1
Q,2,81646,172,v,104,-68
Q,2,81750,163,e,116,-47
Q,2,81866,67, ,350,283
Q,2,82216,108,s,263,155
Q,2,82479,152,w,112,-40
Q,2,82591,84,e,168,84
Q,2,82759,139,e,132,-7
Q,2,82891,83,t,80,-3
Q,2,82971,96, ,145,49
Q,2,83116,93,c,64,-29
Q,2,83180,116,h,144,28
Q,2,83324,72,e,131,59
Q,2,83455,108,e,111,3
Q,2,83566,157,s,89,-68
Q,2,83655,108,e,79,-29
Q,2,83734,157,.,77,-80
Q,2,83811,136, ,274,138
Q,2,84085,120,D,120,0
Q,2,84205,75,o,36,-39
Q,2,84241,100, ,132,32
Q,2,84373,100,y,56,-44
Q,2,84429,135,o,69,-66
Q,2,84498,95,u,56,-39
Q,2,84554,91, ,154,63
Q,2,84708,120,l,81,-39
Q,2,84789,83,i,175,92
Q,2,84964,87,k,76,-11
Q,2,85040,80,e,87,7
Q,2,85127,118, ,142,24
Q,2,85269,108,s,60,-48
Q,2,85329,96,a,148,52
Q,2,85477,80,v,164,84
Q,2,85641,103,o,88,-15
Q,2,85729,80,r,242,162
Q,2,85971,69,y,360,291
Q,2,86331,116, ,709,593
Q,2,87040,88,T,136,48
Q,2,87176,100,h,147,47
Q,2,87323,35,e,64,29
Q,2,87387,41,y,480,439
Q,2,87867,77,',121,44
Q,2,87988,91,v,68,-23
Q,2,88056,64,e,65,1
Q,2,88121,104, ,125,21
Q,2,88246,76,g,77,1
Q,2,88323,84,o,104,20
Q,2,88427,73,t,80,7
Q,2,88507,85, ,92,7
Q,2,88599,85,t,65,-20
Q,2,88664,81,h,80,-1
Q,2,88744,108,a,68,-40
Q,2,88812,84,t,63,-21
Q,2,88875,73, ,113,40
Q,2,88988,91,t,64,-27
Q,2,89052,56,o,125,69
Q,2,89177,93,o,277,184
Q,2,89454,124,.,60,-64
Q,2,89514,133, ,296,163
Q,2,89810,160,A,893,733
Q,2,90703,84,D,245,161
Q,2,90948,96,o,29,-67
Q,2,90977,140, ,178,38
Q,2,91155,92,y,95,3
Q,2,91250,152,o,72,-80
Q,2,91322,117,u,61,-56
Q,2,91383,96, ,288,192
Q,2,91671,128,l,100,-28
Q,2,91771,92,i,230,138
Q,2,92001,72,k,64,-8
Q,2,92065,88,e,36,-52
Q,2,92101,196, ,127,-69
Q,2,92228,121,m,76,-45
Q,2,92304,94,o,191,97
Q,2,92495,64,l,40,-24
Q,2,92535,81,d,284,203
Q,2,92819,135, ,559,424
Q,2,93378,69,T,64,-5
Q,2,93442,101,h,101,0
Q,2,93543,96,a,64,-32
Q,2,93607,96,t,33,-63
Q,2,93640,167, ,107,-60
Q,2,93747,79,i,67,-12
Q,2,93814,89,s,93,4
Q,2,93907,92, ,164,72
Q,2,94071,91,a,64,-27
Q,2,94135,97,l,110,13
Q,2,94245,107,s,100,-7
Q,2,94345,104,o,107,3
Q,2,94452,126, ,269,143
Q,2,94721,82,a,79,-3
Q,2,94800,108,n,64,-44
Q,2,94864,128, ,230,102
Q,2,95094,137,o,68,-69
Q,2,95162,104,p,116,12
Q,2,95278,77,t,109,32
Q,2,95387,172,i,56,-116
Q,2,95443,132,o,175,43
Q,2,95618,89,n,319,230
Q,2,95937,84,.,23,-61
Q,2,95960,153, ,217,64
Q,2,96177,60,I,115,55
Q,2,96292,86,t,60,-26
Q,2,96352,75, ,48,-27
Q,2,96400,100,i,108,8
Q,2,96508,86,s,61,-25
Q,2,96569,79, ,87,8
Q,2,96656,92,t,52,-40
Q,2,96708,116,r,64,-52
Q,2,96772,68,u,161,93
Q,2,96933,88,l,52,-36
Q,2,96985,112,y,100,-12
Q,2,97085,76, ,123,47
Q,2,97208,79,t,51,-28
Q,2,97259,88,h,102,14
Q,2,97361,92,e,572,480
Q,2,97933,85, ,308,223
Q,2,98241,113,m,2607,2494
Q,2,100848,123,a,65,-58
Q,2,100913,97,r,160,63
Q,2,101073,48,u,357,309
Q,2,101430,89,g,107,18
Q,2,101537,117,u,215,98
Q,2,101752,97,a,146,49
Q,2,101898,145,b,73,-72
Q,2,101971,135,l,149,14
Q,2,102120,69,e,137,68
Q,2,102257,105, ,156,51
Q,2,102413,56,t,640,584
Q,2,103053,92,y,69,-23
Q,2,103122,80, ,144,64
Q,2,103266,88,t,36,-52
Q,2,103302,84,h,80,-4
Q,2,103382,153,e,96,-57
Q,2,103478,150, ,124,-26
Q,2,103602,165,m,73,-92
Q,2,103675,107,o,56,-51
Q,2,103731,100,s,63,-37
Q,2,103794,101,t,48,-53
Q,2,103842,127, ,117,-10
Q,2,103959,220,u,80,-140
Q,2,104039,151,n,84,-67
Q,2,104123,144,i,111,-33
Q,2,104234,169,v,72,-97
Q,2,104306,124,e,97,-27
Q,2,104403,75,r,231,156
Q,2,104634,164,s,48,-116
Q,2,104682,148,a,149,1
Q,2,104831,127,l,79,-48
Q,2,104910,105, ,103,-2
Q,2,105013,113,c,134,21
Q,2,105147,112,h,100,-12
Q,2,105247,73,e,136,63
Q,2,105383,84,e,123,39
Q,2,105506,116,s,67,-49
Q,2,105573,102,e,92,-10
Q,2,105665,61, ,6825,6764
Q,2,112490,156,p,159,3
Q,2,112649,157,i,195,38
Q,2,112844,76,e,197,121
Q,2,113041,136,c,52,-84
Q,2,113093,120,e,146,26
Q,2,113239,156, ,129,-27
Q,2,113368,148,o,175,27
Q,2,113543,102,f,100,-2
Q,2,113643,84, ,164,80
Q,2,113807,72,f,73,1
Q,2,113880,71,o,167,96
Q,2,114047,81,o,106,25
Q,2,114153,73,d,552,479
Q,2,114705,116, ,217,101
Q,2,114922,104,t,96,-8
Q,2,115018,100,h,112,12
Q,2,115130,95,a,52,-43
Q,2,115182,88,t,55,-33
Q,2,115237,98, ,49,-49
Q,2,115286,84,i,170,86
Q,2,115456,116,t,127,11
Q,2,115583,101, ,301,200
Q,2,115884,143,o,76,-67
Q,2,115960,95,u,119,24
Q,2,116079,84,g,92,8
Q,2,116171,85,h,94,9
Q,2,116265,46,t,84,38
Q,2,116349,82, ,56,-26
Q,2,116405,106,t,66,-40
Q,2,116471,104,o,76,-28
Q,2,116547,69, ,115,46
Q,2,116662,112,b,57,-55
Q,2,116719,91,e,88,-3
Q,2,116807,100, ,166,66
Q,2,116973,105,e,77,-28
Q,2,117050,188,v,127,-61
Q,2,117177,133,e,60,-73
Q,2,117237,108,r,80,-28
Q,2,117317,69,y,181,112
Q,2,117498,131,b,72,-59
Q,2,117570,132,o,99,-33
Q,2,117669,100,d,108,8
Q,2,117777,81,y,199,118
Q,2,117976,81,',84,3
Q,2,118060,86,s,64,-22
Q,2,118124,121, ,157,36
Q,2,118281,131,f,92,-39
Q,2,118373,92,a,261,169
Q,2,118634,47,o,36,-11
Q,2,118670,19,f,446,427
Q,2,119116,77,v,136,59
Q,2,119252,56,o,94,38
Q,2,119346,61,r,81,20
Q,2,119427,49,i,99,50
Q,2,119526,96,t,63,-33
Q,2,119589,100,e,97,-3
Q,2,119686,100,.,60,-40
Q,2,119746,100, ,NA,NA
